GCAACAAGATT -> CAACAAGATTG
CAACAAGATTG -> AACAAGATTGA
AACAAGATTGA -> ACAAGATTGAA
ACAAGATTGAA -> CAAGATTGAAA
CAAGATTGAAA -> AAGATTGAAAA
AAGATTGAAAA -> AGATTGAAAAA
AGATTGAAAAA -> GATTGAAAAAT
GATTGAAAAAT -> ATTGAAAAATA
ATTGAAAAATA -> TTGAAAAATAC
TTGAAAAATAC -> TGAAAAATACA
TGAAAAATACA -> GAAAAATACAA
GAAAAATACAA -> AAAAATACAAC
AAAAATACAAC -> AAAATACAACC
AAAATACAACC -> AAATACAACCC
AAATACAACCC -> AATACAACCCG
AATACAACCCG -> ATACAACCCGA
ATACAACCCGA -> TACAACCCGAG
TACAACCCGAG -> ACAACCCGAGG
ACAACCCGAGG -> CAACCCGAGGG
CAACCCGAGGG -> AACCCGAGGGA
AACCCGAGGGA -> ACCCGAGGGAC
ACCCGAGGGAC -> CCCGAGGGACG
CCCGAGGGACG -> CCGAGGGACGG
CCGAGGGACGG -> CGAGGGACGGA
CGAGGGACGGA -> GAGGGACGGAG
GAGGGACGGAG -> AGGGACGGAGT
AGGGACGGAGT -> GGGACGGAGTC
GGGACGGAGTC -> GGACGGAGTCT
GGACGGAGTCT -> GACGGAGTCTT
GACGGAGTCTT -> ACGGAGTCTTG
ACGGAGTCTTG -> CGGAGTCTTGG
CGGAGTCTTGG -> GGAGTCTTGGC
GGAGTCTTGGC -> GAGTCTTGGCT
GAGTCTTGGCT -> AGTCTTGGCTA
AGTCTTGGCTA -> GTCTTGGCTAC
GTCTTGGCTAC -> TCTTGGCTACC
TCTTGGCTACC -> CTTGGCTACCT
CTTGGCTACCT -> TTGGCTACCTC
TTGGCTACCTC -> TGGCTACCTCT
TGGCTACCTCT -> GGCTACCTCTT
GGCTACCTCTT -> GCTACCTCTTT
GCTACCTCTTT -> CTACCTCTTTA
CTACCTCTTTA -> TACCTCTTTAA
TACCTCTTTAA -> ACCTCTTTAAA
ACCTCTTTAAA -> CCTCTTTAAAC
CCTCTTTAAAC -> CTCTTTAAACT
CTCTTTAAACT -> TCTTTAAACTC
TCTTTAAACTC -> CTTTAAACTCT
CTTTAAACTCT -> TTTAAACTCTA
TTTAAACTCTA -> TTAAACTCTAG
TTAAACTCTAG -> TAAACTCTAGG
TAAACTCTAGG -> AAACTCTAGGA
AAACTCTAGGA -> AACTCTAGGAA
AACTCTAGGAA -> ACTCTAGGAAA
ACTCTAGGAAA -> CTCTAGGAAAT
CTCTAGGAAAT -> TCTAGGAAATG
TCTAGGAAATG -> CTAGGAAATGG
CTAGGAAATGG -> TAGGAAATGGA
TAGGAAATGGA -> AGGAAATGGAT
AGGAAATGGAT -> GGAAATGGATG
GGAAATGGATG -> GAAATGGATGG
GAAATGGATGG -> AAATGGATGGT
AAATGGATGGT -> AATGGATGGTA
AATGGATGGTA -> ATGGATGGTAA
ATGGATGGTAA -> TGGATGGTAAT
TGGATGGTAAT -> GGATGGTAATA
GGATGGTAATA -> GATGGTAATAG
GATGGTAATAG -> ATGGTAATAGT
ATGGTAATAGT -> TGGTAATAGTT
TGGTAATAGTT -> GGTAATAGTTA
GGTAATAGTTA -> GTAATAGTTAC
GTAATAGTTAC -> TAATAGTTACC
TAATAGTTACC -> AATAGTTACCA
AATAGTTACCA -> ATAGTTACCAC
ATAGTTACCAC -> TAGTTACCACC
TAGTTACCACC -> AGTTACCACCC
AGTTACCACCC -> GTTACCACCCA
GTTACCACCCA -> TTACCACCCAA
TTACCACCCAA -> TACCACCCAAG
TACCACCCAAG -> ACCACCCAAGT
ACCACCCAAGT -> CCACCCAAGTA
CCACCCAAGTA -> CACCCAAGTAA
CACCCAAGTAA -> ACCCAAGTAAT
ACCCAAGTAAT -> CCCAAGTAATC
CCCAAGTAATC -> CCAAGTAATCT
CCAAGTAATCT -> CAAGTAATCTT
CAAGTAATCTT -> AAGTAATCTTG
AAGTAATCTTG -> AGTAATCTTGT
AGTAATCTTGT -> GTAATCTTGTG
GTAATCTTGTG -> TAATCTTGTGC
TAATCTTGTGC -> AATCTTGTGCG
AATCTTGTGCG -> ATCTTGTGCGG
ATCTTGTGCGG -> TCTTGTGCGGG
TCTTGTGCGGG -> CTTGTGCGGGT
CTTGTGCGGGT -> TTGTGCGGGTC
TTGTGCGGGTC -> TGTGCGGGTCA
TGTGCGGGTCA -> GTGCGGGTCAT
GTGCGGGTCAT -> TGCGGGTCATA
TGCGGGTCATA -> GCGGGTCATAA
GCGGGTCATAA -> CGGGTCATAAT
CGGGTCATAAT -> GGGTCATAATC
GGGTCATAATC -> GGTCATAATCT
GGTCATAATCT -> GTCATAATCTA
GTCATAATCTA -> TCATAATCTAA
TCATAATCTAA -> CATAATCTAAC
CATAATCTAAC -> ATAATCTAACA
ATAATCTAACA -> TAATCTAACAT
TAATCTAACAT -> AATCTAACATT
AATCTAACATT -> ATCTAACATTA
ATCTAACATTA -> TCTAACATTAC
TCTAACATTAC -> CTAACATTACT
CTAACATTACT -> TAACATTACTG
TAACATTACTG -> AACATTACTGT
AACATTACTGT -> ACATTACTGTC
ACATTACTGTC -> CATTACTGTCT
CATTACTGTCT -> ATTACTGTCTG
ATTACTGTCTG -> TTACTGTCTGG
TTACTGTCTGG -> TACTGTCTGGC
TACTGTCTGGC -> ACTGTCTGGCT
ACTGTCTGGCT -> CTGTCTGGCTT
CTGTCTGGCTT -> TGTCTGGCTTT
TGTCTGGCTTT -> GTCTGGCTTTA
GTCTGGCTTTA -> TCTGGCTTTAT
TCTGGCTTTAT -> CTGGCTTTATA
CTGGCTTTATA -> TGGCTTTATAA
TGGCTTTATAA -> GGCTTTATAAG
GGCTTTATAAG -> GCTTTATAAGA
GCTTTATAAGA -> CTTTATAAGAT
CTTTATAAGAT -> TTTATAAGATC
TTTATAAGATC -> TTATAAGATCT
TTATAAGATCT -> TATAAGATCTA
TATAAGATCTA -> ATAAGATCTAC
ATAAGATCTAC -> TAAGATCTACG
TAAGATCTACG -> AAGATCTACGA
AAGATCTACGA -> AGATCTACGAC
AGATCTACGAC -> GATCTACGACC
GATCTACGACC -> ATCTACGACCG
ATCTACGACCG -> TCTACGACCGA
TCTACGACCGA -> CTACGACCGAC
CTACGACCGAC -> TACGACCGACA
TACGACCGACA -> ACGACCGACAA
ACGACCGACAA -> CGACCGACAAC
CGACCGACAAC -> GACCGACAACT
GACCGACAACT -> ACCGACAACTC
ACCGACAACTC -> CCGACAACTCA
CCGACAACTCA -> CGACAACTCAT
CGACAACTCAT -> GACAACTCATG
GACAACTCATG -> ACAACTCATGG
ACAACTCATGG -> CAACTCATGGC
CAACTCATGGC -> AACTCATGGCG
AACTCATGGCG -> ACTCATGGCGA
ACTCATGGCGA -> CTCATGGCGAT
CTCATGGCGAT -> TCATGGCGATA
TCATGGCGATA -> CATGGCGATAG
CATGGCGATAG -> ATGGCGATAGG
ATGGCGATAGG -> TGGCGATAGGT
TGGCGATAGGT -> GGCGATAGGTA
GGCGATAGGTA -> GCGATAGGTAA
GCGATAGGTAA -> CGATAGGTAAC
CGATAGGTAAC -> GATAGGTAACC
GATAGGTAACC -> ATAGGTAACCT
ATAGGTAACCT -> TAGGTAACCTA
TAGGTAACCTA -> AGGTAACCTAT
AGGTAACCTAT -> GGTAACCTATC
GGTAACCTATC -> GTAACCTATCT
GTAACCTATCT -> TAACCTATCTA
TAACCTATCTA -> AACCTATCTAC
AACCTATCTAC -> ACCTATCTACT
ACCTATCTACT -> CCTATCTACTC
CCTATCTACTC -> CTATCTACTCT
CTATCTACTCT -> TATCTACTCTA
TATCTACTCTA -> ATCTACTCTAC
ATCTACTCTAC -> TCTACTCTACC
TCTACTCTACC -> CTACTCTACCC
CTACTCTACCC -> TACTCTACCCG
TACTCTACCCG -> ACTCTACCCGG,ACTCTACCCGT
ACTCTACCCGG -> CTCTACCCGGA
CTCTACCCGGA -> TCTACCCGGAG
TCTACCCGGAG -> CTACCCGGAGA
CTACCCGGAGA -> TACCCGGAGAT
TACCCGGAGAT -> ACCCGGAGATA
ACCCGGAGATA -> CCCGGAGATAT
CCCGGAGATAT -> CCGGAGATATC
CCGGAGATATC -> CGGAGATATCC
CGGAGATATCC -> GGAGATATCCC
GGAGATATCCC -> GAGATATCCCC
GAGATATCCCC -> AGATATCCCCT
AGATATCCCCT -> GATATCCCCTG
GATATCCCCTG -> ATATCCCCTGT
ATATCCCCTGT -> TATCCCCTGTG
TATCCCCTGTG -> ATCCCCTGTGT
ATCCCCTGTGT -> TCCCCTGTGTG
TCCCCTGTGTG -> CCCCTGTGTGC
CCCCTGTGTGC -> CCCTGTGTGCC
CCCTGTGTGCC -> CCTGTGTGCCG
CCTGTGTGCCG -> CTGTGTGCCGT
CTGTGTGCCGT -> TGTGTGCCGTG
TGTGTGCCGTG -> GTGTGCCGTGC
GTGTGCCGTGC -> TGTGCCGTGCG
TGTGCCGTGCG -> GTGCCGTGCGC
GTGCCGTGCGC -> TGCCGTGCGCA
TGCCGTGCGCA -> GCCGTGCGCAA
GCCGTGCGCAA -> CCGTGCGCAAC
CCGTGCGCAAC -> CGTGCGCAACG
CGTGCGCAACG -> GTGCGCAACGA
GTGCGCAACGA -> TGCGCAACGAG
TGCGCAACGAG -> GCGCAACGAGC
GCGCAACGAGC -> CGCAACGAGCA
CGCAACGAGCA -> GCAACGAGCAG
GCAACGAGCAG -> CAACGAGCAGC
CAACGAGCAGC -> AACGAGCAGCG
AACGAGCAGCG -> ACGAGCAGCGG
ACGAGCAGCGG -> CGAGCAGCGGA
CGAGCAGCGGA -> GAGCAGCGGAA
GAGCAGCGGAA -> AGCAGCGGAAG
AGCAGCGGAAG -> GCAGCGGAAGT
GCAGCGGAAGT -> CAGCGGAAGTT
CAGCGGAAGTT -> AGCGGAAGTTG
AGCGGAAGTTG -> GCGGAAGTTGC
GCGGAAGTTGC -> CGGAAGTTGCC
CGGAAGTTGCC -> GGAAGTTGCCA
GGAAGTTGCCA -> GAAGTTGCCAT
GAAGTTGCCAT -> AAGTTGCCATA
AAGTTGCCATA -> AGTTGCCATAA
AGTTGCCATAA -> GTTGCCATAAT
GTTGCCATAAT -> TTGCCATAATA
TTGCCATAATA -> TGCCATAATAC
TGCCATAATAC -> GCCATAATACC
GCCATAATACC -> CCATAATACCC
CCATAATACCC -> CATAATACCCA
CATAATACCCA -> ATAATACCCAT
ATAATACCCAT -> TAATACCCATT
TAATACCCATT -> AATACCCATTT
AATACCCATTT -> ATACCCATTTT
ATACCCATTTT -> TACCCATTTTA
TACCCATTTTA -> ACCCATTTTAC
ACCCATTTTAC -> CCCATTTTACC
CCCATTTTACC -> CCATTTTACCA
CCATTTTACCA -> CATTTTACCAT
CATTTTACCAT -> ATTTTACCATA
ATTTTACCATA -> TTTTACCATAG
TTTTACCATAG -> TTTACCATAGG
TTTACCATAGG -> TTACCATAGGG
TTACCATAGGG -> TACCATAGGGC
TACCATAGGGC -> ACCATAGGGCC
ACCATAGGGCC -> CCATAGGGCCT
CCATAGGGCCT -> CATAGGGCCTA
CATAGGGCCTA -> ATAGGGCCTAT
ATAGGGCCTAT -> TAGGGCCTATG
TAGGGCCTATG -> AGGGCCTATGC
AGGGCCTATGC -> GGGCCTATGCG
GGGCCTATGCG -> GGCCTATGCGC
GGCCTATGCGC -> GCCTATGCGCA
GCCTATGCGCA -> CCTATGCGCAG
CCTATGCGCAG -> CTATGCGCAGT
CTATGCGCAGT -> TATGCGCAGTG
TATGCGCAGTG -> ATGCGCAGTGA
ATGCGCAGTGA -> TGCGCAGTGAT
TGCGCAGTGAT -> GCGCAGTGATG
GCGCAGTGATG -> CGCAGTGATGG
CGCAGTGATGG -> GCAGTGATGGC
GCAGTGATGGC -> CAGTGATGGCG
CAGTGATGGCG -> AGTGATGGCGC
AGTGATGGCGC -> GTGATGGCGCC
GTGATGGCGCC -> TGATGGCGCCT
TGATGGCGCCT -> GATGGCGCCTT
GATGGCGCCTT -> ATGGCGCCTTG
ATGGCGCCTTG -> TGGCGCCTTGA
TGGCGCCTTGA -> GGCGCCTTGAC
GGCGCCTTGAC -> GCGCCTTGACA
GCGCCTTGACA -> CGCCTTGACAG
CGCCTTGACAG -> GCCTTGACAGC
GCCTTGACAGC -> CCTTGACAGCG
CCTTGACAGCG -> CTTGACAGCGT
CTTGACAGCGT -> TTGACAGCGTA
TTGACAGCGTA -> TGACAGCGTAC
TGACAGCGTAC -> GACAGCGTACC
GACAGCGTACC -> ACAGCGTACCT
ACAGCGTACCT -> CAGCGTACCTT
CAGCGTACCTT -> AGCGTACCTTA
AGCGTACCTTA -> GCGTACCTTAT
GCGTACCTTAT -> CGTACCTTATT
CGTACCTTATT -> GTACCTTATTC
GTACCTTATTC -> TACCTTATTCA
TACCTTATTCA -> ACCTTATTCAT
ACCTTATTCAT -> CCTTATTCATA
CCTTATTCATA -> CTTATTCATAG
CTTATTCATAG -> TTATTCATAGT
TTATTCATAGT -> TATTCATAGTA
TATTCATAGTA -> ATTCATAGTAG
ATTCATAGTAG -> TTCATAGTAGC
TTCATAGTAGC -> TCATAGTAGCT
TCATAGTAGCT -> CATAGTAGCTG
CATAGTAGCTG -> ATAGTAGCTGC
ATAGTAGCTGC -> TAGTAGCTGCG
TAGTAGCTGCG -> AGTAGCTGCGT
AGTAGCTGCGT -> GTAGCTGCGTG
GTAGCTGCGTG -> TAGCTGCGTGT
TAGCTGCGTGT -> AGCTGCGTGTA
AGCTGCGTGTA -> GCTGCGTGTAC
GCTGCGTGTAC -> CTGCGTGTACC
CTGCGTGTACC -> TGCGTGTACCT
TGCGTGTACCT -> GCGTGTACCTT
GCGTGTACCTT -> CGTGTACCTTA
CGTGTACCTTA -> GTGTACCTTAA
GTGTACCTTAA -> TGTACCTTAAG
TGTACCTTAAG -> GTACCTTAAGC
GTACCTTAAGC -> TACCTTAAGCG
TACCTTAAGCG -> ACCTTAAGCGT
ACCTTAAGCGT -> CCTTAAGCGTC
CCTTAAGCGTC -> CTTAAGCGTCT
CTTAAGCGTCT -> TTAAGCGTCTC
TTAAGCGTCTC -> TAAGCGTCTCC
TAAGCGTCTCC -> AAGCGTCTCCT
AAGCGTCTCCT -> AGCGTCTCCTA
AGCGTCTCCTA -> GCGTCTCCTAT
GCGTCTCCTAT -> CGTCTCCTATA
CGTCTCCTATA -> GTCTCCTATAG
GTCTCCTATAG -> TCTCCTATAGG
TCTCCTATAGG -> CTCCTATAGGT
CTCCTATAGGT -> TCCTATAGGTA
TCCTATAGGTA -> CCTATAGGTAT
CCTATAGGTAT -> CTATAGGTATT
CTATAGGTATT -> TATAGGTATTG
TATAGGTATTG -> ATAGGTATTGC
ATAGGTATTGC -> TAGGTATTGCC
TAGGTATTGCC -> AGGTATTGCCT
AGGTATTGCCT -> GGTATTGCCTA
GGTATTGCCTA -> GTATTGCCTAG
GTATTGCCTAG -> TATTGCCTAGC
TATTGCCTAGC -> ATTGCCTAGCG
ATTGCCTAGCG -> TTGCCTAGCGA
TTGCCTAGCGA -> TGCCTAGCGAT
TGCCTAGCGAT -> GCCTAGCGATA
GCCTAGCGATA -> CCTAGCGATAC
CCTAGCGATAC -> CTAGCGATACG
CTAGCGATACG -> TAGCGATACGA
TAGCGATACGA -> AGCGATACGAG
AGCGATACGAG -> GCGATACGAGA
GCGATACGAGA -> CGATACGAGAG
CGATACGAGAG -> GATACGAGAGT
GATACGAGAGT -> ATACGAGAGTC
ATACGAGAGTC -> TACGAGAGTCT
TACGAGAGTCT -> ACGAGAGTCTT
ACGAGAGTCTT -> CGAGAGTCTTT
CGAGAGTCTTT -> GAGAGTCTTTA
GAGAGTCTTTA -> AGAGTCTTTAG
AGAGTCTTTAG -> GAGTCTTTAGA
GAGTCTTTAGA -> AGTCTTTAGAC
AGTCTTTAGAC -> GTCTTTAGACG
GTCTTTAGACG -> TCTTTAGACGT
TCTTTAGACGT -> CTTTAGACGTA
CTTTAGACGTA -> TTTAGACGTAA
TTTAGACGTAA -> TTAGACGTAAA
TTAGACGTAAA -> TAGACGTAAAC
TAGACGTAAAC -> AGACGTAAACA
AGACGTAAACA -> GACGTAAACAG
GACGTAAACAG -> ACGTAAACAGT
ACGTAAACAGT -> CGTAAACAGTG
CGTAAACAGTG -> GTAAACAGTGA
GTAAACAGTGA -> TAAACAGTGAA
TAAACAGTGAA -> AAACAGTGAAA
AAACAGTGAAA -> AACAGTGAAAT
AACAGTGAAAT -> ACAGTGAAATT
ACAGTGAAATT -> CAGTGAAATTA
CAGTGAAATTA -> AGTGAAATTAT
AGTGAAATTAT -> GTGAAATTATA
GTGAAATTATA -> TGAAATTATAG
TGAAATTATAG -> GAAATTATAGA
GAAATTATAGA -> AAATTATAGAA
AAATTATAGAA -> AATTATAGAAA
AATTATAGAAA -> ATTATAGAAAC
ATTATAGAAAC -> TTATAGAAACG
TTATAGAAACG -> TATAGAAACGC
TATAGAAACGC -> ATAGAAACGCT
ATAGAAACGCT -> TAGAAACGCTA
TAGAAACGCTA -> AGAAACGCTAC
AGAAACGCTAC -> GAAACGCTACT
GAAACGCTACT -> AAACGCTACTA
AAACGCTACTA -> AACGCTACTAT
AACGCTACTAT -> ACGCTACTATC
ACGCTACTATC -> CGCTACTATCA
CGCTACTATCA -> GCTACTATCAG
GCTACTATCAG -> CTACTATCAGA
CTACTATCAGA -> TACTATCAGAC
TACTATCAGAC -> ACTATCAGACG
ACTATCAGACG -> CTATCAGACGG
CTATCAGACGG -> TATCAGACGGC
TATCAGACGGC -> ATCAGACGGCT
ATCAGACGGCT -> TCAGACGGCTA
TCAGACGGCTA -> CAGACGGCTAT
CAGACGGCTAT -> AGACGGCTATA
AGACGGCTATA -> GACGGCTATAC
GACGGCTATAC -> ACGGCTATACA
ACGGCTATACA -> CGGCTATACAT
CGGCTATACAT -> GGCTATACATG
GGCTATACATG -> GCTATACATGT
GCTATACATGT -> CTATACATGTT
CTATACATGTT -> TATACATGTTG
TATACATGTTG -> ATACATGTTGT
ATACATGTTGT -> TACATGTTGTG
TACATGTTGTG -> ACATGTTGTGC
ACATGTTGTGC -> CATGTTGTGCT
CATGTTGTGCT -> ATGTTGTGCTT
ATGTTGTGCTT -> TGTTGTGCTTC
TGTTGTGCTTC -> GTTGTGCTTCT
GTTGTGCTTCT -> TTGTGCTTCTT
TTGTGCTTCTT -> TGTGCTTCTTA
TGTGCTTCTTA -> GTGCTTCTTAG
GTGCTTCTTAG -> TGCTTCTTAGG
TGCTTCTTAGG -> GCTTCTTAGGC
GCTTCTTAGGC -> CTTCTTAGGCG
CTTCTTAGGCG -> TTCTTAGGCGC
TTCTTAGGCGC -> TCTTAGGCGCT
TCTTAGGCGCT -> CTTAGGCGCTT
CTTAGGCGCTT -> TTAGGCGCTTA
TTAGGCGCTTA -> TAGGCGCTTAT
TAGGCGCTTAT -> AGGCGCTTATG
AGGCGCTTATG -> GGCGCTTATGT
GGCGCTTATGT -> GCGCTTATGTA
GCGCTTATGTA -> CGCTTATGTAA
CGCTTATGTAA -> GCTTATGTAAT
GCTTATGTAAT -> CTTATGTAATC
CTTATGTAATC -> TTATGTAATCC
TTATGTAATCC -> TATGTAATCCC
TATGTAATCCC -> ATGTAATCCCC
ATGTAATCCCC -> TGTAATCCCCG
TGTAATCCCCG -> GTAATCCCCGC
GTAATCCCCGC -> TAATCCCCGCC
TAATCCCCGCC -> AATCCCCGCCA
AATCCCCGCCA -> ATCCCCGCCAG
ATCCCCGCCAG -> TCCCCGCCAGC
TCCCCGCCAGC -> CCCCGCCAGCT
CCCCGCCAGCT -> CCCGCCAGCTG
CCCGCCAGCTG -> CCGCCAGCTGT
CCGCCAGCTGT -> CGCCAGCTGTG
CGCCAGCTGTG -> GCCAGCTGTGA
GCCAGCTGTGA -> CCAGCTGTGAT
CCAGCTGTGAT -> CAGCTGTGATC
CAGCTGTGATC -> AGCTGTGATCT
AGCTGTGATCT -> GCTGTGATCTG
GCTGTGATCTG -> CTGTGATCTGA
CTGTGATCTGA -> TGTGATCTGAC
TGTGATCTGAC -> GTGATCTGACG
GTGATCTGACG -> TGATCTGACGC
TGATCTGACGC -> GATCTGACGCT
GATCTGACGCT -> ATCTGACGCTT
ATCTGACGCTT -> TCTGACGCTTC
TCTGACGCTTC -> CTGACGCTTCA
CTGACGCTTCA -> TGACGCTTCAA
TGACGCTTCAA -> GACGCTTCAAA
GACGCTTCAAA -> ACGCTTCAAAC
ACGCTTCAAAC -> CGCTTCAAACT
CGCTTCAAACT -> GCTTCAAACTG
GCTTCAAACTG -> CTTCAAACTGG
CTTCAAACTGG -> TTCAAACTGGT
TTCAAACTGGT -> TCAAACTGGTA
TCAAACTGGTA -> CAAACTGGTAC
CAAACTGGTAC -> AAACTGGTACG
AAACTGGTACG -> AACTGGTACGA
AACTGGTACGA -> ACTGGTACGAG
ACTGGTACGAG -> CTGGTACGAGA
CTGGTACGAGA -> TGGTACGAGAT
TGGTACGAGAT -> GGTACGAGATA
GGTACGAGATA -> GTACGAGATAC
GTACGAGATAC -> TACGAGATACT
TACGAGATACT -> ACGAGATACTG
ACGAGATACTG -> CGAGATACTGG
CGAGATACTGG -> GAGATACTGGT
GAGATACTGGT -> AGATACTGGTC
AGATACTGGTC -> GATACTGGTCG
GATACTGGTCG -> ATACTGGTCGT
ATACTGGTCGT -> TACTGGTCGTT
TACTGGTCGTT -> ACTGGTCGTTT
ACTGGTCGTTT -> CTGGTCGTTTG
CTGGTCGTTTG -> TGGTCGTTTGT
TGGTCGTTTGT -> GGTCGTTTGTT
GGTCGTTTGTT -> GTCGTTTGTTC
GTCGTTTGTTC -> TCGTTTGTTCC
TCGTTTGTTCC -> CGTTTGTTCCT
CGTTTGTTCCT -> GTTTGTTCCTT
GTTTGTTCCTT -> TTTGTTCCTTC
TTTGTTCCTTC -> TTGTTCCTTCG
TTGTTCCTTCG -> TGTTCCTTCGC
TGTTCCTTCGC -> GTTCCTTCGCC
GTTCCTTCGCC -> TTCCTTCGCCC
TTCCTTCGCCC -> TCCTTCGCCCG
TCCTTCGCCCG -> CCTTCGCCCGC
CCTTCGCCCGC -> CTTCGCCCGCA
CTTCGCCCGCA -> TTCGCCCGCAG
TTCGCCCGCAG -> TCGCCCGCAGA
TCGCCCGCAGA -> CGCCCGCAGAG
CGCCCGCAGAG -> GCCCGCAGAGG
GCCCGCAGAGG -> CCCGCAGAGGC
CCCGCAGAGGC -> CCGCAGAGGCT
CCGCAGAGGCT -> CGCAGAGGCTG
CGCAGAGGCTG -> GCAGAGGCTGG
GCAGAGGCTGG -> CAGAGGCTGGA
CAGAGGCTGGA -> AGAGGCTGGAA
AGAGGCTGGAA -> GAGGCTGGAAC
GAGGCTGGAAC -> AGGCTGGAACT
AGGCTGGAACT -> GGCTGGAACTA
GGCTGGAACTA -> GCTGGAACTAC
GCTGGAACTAC -> CTGGAACTACC
CTGGAACTACC -> TGGAACTACCT
TGGAACTACCT -> GGAACTACCTC
GGAACTACCTC -> GAACTACCTCT
GAACTACCTCT -> AACTACCTCTG
AACTACCTCTG -> ACTACCTCTGA
ACTACCTCTGA -> CTACCTCTGAG
CTACCTCTGAG -> TACCTCTGAGG
TACCTCTGAGG -> ACCTCTGAGGG
ACCTCTGAGGG -> CCTCTGAGGGC
CCTCTGAGGGC -> CTCTGAGGGCT
CTCTGAGGGCT -> TCTGAGGGCTC
TCTGAGGGCTC -> CTGAGGGCTCA
CTGAGGGCTCA -> TGAGGGCTCAC
TGAGGGCTCAC -> GAGGGCTCACC
GAGGGCTCACC -> AGGGCTCACCG
AGGGCTCACCG -> GGGCTCACCGA
GGGCTCACCGA -> GGCTCACCGAC
GGCTCACCGAC -> GCTCACCGACC
GCTCACCGACC -> CTCACCGACCC
CTCACCGACCC -> TCACCGACCCT
TCACCGACCCT -> CACCGACCCTC
CACCGACCCTC -> ACCGACCCTCC
ACCGACCCTCC -> CCGACCCTCCG
CCGACCCTCCG -> CGACCCTCCGA
CGACCCTCCGA -> GACCCTCCGAA
GACCCTCCGAA -> ACCCTCCGAAG
ACCCTCCGAAG -> CCCTCCGAAGG
CCCTCCGAAGG -> CCTCCGAAGGG
CCTCCGAAGGG -> CTCCGAAGGGA
CTCCGAAGGGA -> TCCGAAGGGAA
TCCGAAGGGAA -> CCGAAGGGAAC
CCGAAGGGAAC -> CGAAGGGAACT
CGAAGGGAACT -> GAAGGGAACTC
GAAGGGAACTC -> AAGGGAACTCC
AAGGGAACTCC -> AGGGAACTCCT
AGGGAACTCCT -> GGGAACTCCTC
GGGAACTCCTC -> GGAACTCCTCG
GGAACTCCTCG -> GAACTCCTCGG
GAACTCCTCGG -> AACTCCTCGGC
AACTCCTCGGC -> ACTCCTCGGCA
ACTCCTCGGCA -> CTCCTCGGCAT
CTCCTCGGCAT -> TCCTCGGCATA
TCCTCGGCATA -> CCTCGGCATAC
CCTCGGCATAC -> CTCGGCATACC
CTCGGCATACC -> TCGGCATACCC
TCGGCATACCC -> CGGCATACCCC
CGGCATACCCC -> GGCATACCCCG
GGCATACCCCG -> GCATACCCCGA
GCATACCCCGA -> CATACCCCGAT
CATACCCCGAT -> ATACCCCGATC
ATACCCCGATC -> TACCCCGATCC
TACCCCGATCC -> ACCCCGATCCG
ACCCCGATCCG -> CCCCGATCCGG
CCCCGATCCGG -> CCCGATCCGGG
CCCGATCCGGG -> CCGATCCGGGT
CCGATCCGGGT -> CGATCCGGGTA
CGATCCGGGTA -> GATCCGGGTAT
GATCCGGGTAT -> ATCCGGGTATC
ATCCGGGTATC -> TCCGGGTATCA
TCCGGGTATCA -> CCGGGTATCAG
CCGGGTATCAG -> CGGGTATCAGC
CGGGTATCAGC -> GGGTATCAGCC
GGGTATCAGCC -> GGTATCAGCCT
GGTATCAGCCT -> GTATCAGCCTG
GTATCAGCCTG -> TATCAGCCTGT
TATCAGCCTGT -> ATCAGCCTGTG
ATCAGCCTGTG -> TCAGCCTGTGC
TCAGCCTGTGC -> CAGCCTGTGCC
CAGCCTGTGCC -> AGCCTGTGCCT
AGCCTGTGCCT -> GCCTGTGCCTT
GCCTGTGCCTT -> CCTGTGCCTTT
CCTGTGCCTTT -> CTGTGCCTTTG
CTGTGCCTTTG -> TGTGCCTTTGT
TGTGCCTTTGT -> GTGCCTTTGTT
GTGCCTTTGTT -> TGCCTTTGTTA
TGCCTTTGTTA -> GCCTTTGTTAC
GCCTTTGTTAC -> CCTTTGTTACG
CCTTTGTTACG -> CTTTGTTACGT
CTTTGTTACGT -> TTTGTTACGTG
TTTGTTACGTG -> TTGTTACGTGT
TTGTTACGTGT -> TGTTACGTGTA
TGTTACGTGTA -> GTTACGTGTAG
GTTACGTGTAG -> TTACGTGTAGT
TTACGTGTAGT -> TACGTGTAGTG
TACGTGTAGTG -> ACGTGTAGTGA
ACGTGTAGTGA -> CGTGTAGTGAC
CGTGTAGTGAC -> GTGTAGTGACG
GTGTAGTGACG -> TGTAGTGACGA
TGTAGTGACGA -> GTAGTGACGAC
GTAGTGACGAC -> TAGTGACGACC
TAGTGACGACC -> AGTGACGACCG
AGTGACGACCG -> GTGACGACCGA
GTGACGACCGA -> TGACGACCGAT
TGACGACCGAT -> GACGACCGATT
GACGACCGATT -> ACGACCGATTA
ACGACCGATTA -> CGACCGATTAC
CGACCGATTAC -> GACCGATTACT
GACCGATTACT -> ACCGATTACTT
ACCGATTACTT -> CCGATTACTTG
CCGATTACTTG -> CGATTACTTGG
CGATTACTTGG -> GATTACTTGGT
GATTACTTGGT -> ATTACTTGGTC
ATTACTTGGTC -> TTACTTGGTCT
TTACTTGGTCT -> TACTTGGTCTC
TACTTGGTCTC -> ACTTGGTCTCA
ACTTGGTCTCA -> CTTGGTCTCAC
CTTGGTCTCAC -> TTGGTCTCACT
TTGGTCTCACT -> TGGTCTCACTG
TGGTCTCACTG -> GGTCTCACTGG
GGTCTCACTGG -> GTCTCACTGGG
GTCTCACTGGG -> TCTCACTGGGT
TCTCACTGGGT -> CTCACTGGGTT
CTCACTGGGTT -> TCACTGGGTTC
TCACTGGGTTC -> CACTGGGTTCA
CACTGGGTTCA -> ACTGGGTTCAG
ACTGGGTTCAG -> CTGGGTTCAGC
CTGGGTTCAGC -> TGGGTTCAGCC
TGGGTTCAGCC -> GGGTTCAGCCT
GGGTTCAGCCT -> GGTTCAGCCTT
GGTTCAGCCTT -> GTTCAGCCTTC
GTTCAGCCTTC -> TTCAGCCTTCG
TTCAGCCTTCG -> TCAGCCTTCGG
TCAGCCTTCGG -> CAGCCTTCGGG
CAGCCTTCGGG -> AGCCTTCGGGT
AGCCTTCGGGT -> GCCTTCGGGTC
GCCTTCGGGTC -> CCTTCGGGTCT
CCTTCGGGTCT -> CTTCGGGTCTC
CTTCGGGTCTC -> TTCGGGTCTCC
TTCGGGTCTCC -> TCGGGTCTCCT
TCGGGTCTCCT -> CGGGTCTCCTT
CGGGTCTCCTT -> GGGTCTCCTTT
GGGTCTCCTTT -> GGTCTCCTTTT
GGTCTCCTTTT -> GTCTCCTTTTT
GTCTCCTTTTT -> TCTCCTTTTTC
TCTCCTTTTTC -> CTCCTTTTTCC
CTCCTTTTTCC -> TCCTTTTTCCA
TCCTTTTTCCA -> CCTTTTTCCAT
CCTTTTTCCAT -> CTTTTTCCATA
CTTTTTCCATA -> TTTTTCCATAG
TTTTTCCATAG -> TTTTCCATAGT
TTTTCCATAGT -> TTTCCATAGTT
TTTCCATAGTT -> TTCCATAGTTG
TTCCATAGTTG -> TCCATAGTTGG
TCCATAGTTGG -> CCATAGTTGGC
CCATAGTTGGC -> CATAGTTGGCC
CATAGTTGGCC -> ATAGTTGGCCT
ATAGTTGGCCT -> TAGTTGGCCTC
TAGTTGGCCTC -> AGTTGGCCTCC
AGTTGGCCTCC -> GTTGGCCTCCA
GTTGGCCTCCA -> TTGGCCTCCAG
TTGGCCTCCAG -> TGGCCTCCAGC
TGGCCTCCAGC -> GGCCTCCAGCG
GGCCTCCAGCG -> GCCTCCAGCGG
GCCTCCAGCGG -> CCTCCAGCGGC
CCTCCAGCGGC -> CTCCAGCGGCG
CTCCAGCGGCG -> TCCAGCGGCGA
TCCAGCGGCGA -> CCAGCGGCGAC
CCAGCGGCGAC -> CAGCGGCGACC
CAGCGGCGACC -> AGCGGCGACCC
AGCGGCGACCC -> GCGGCGACCCG
GCGGCGACCCG -> CGGCGACCCGA
CGGCGACCCGA -> GGCGACCCGAA
GGCGACCCGAA -> GCGACCCGAAA
GCGACCCGAAA -> CGACCCGAAAG
CGACCCGAAAG -> GACCCGAAAGT
GACCCGAAAGT -> ACCCGAAAGTT
ACCCGAAAGTT -> CCCGAAAGTTT
CCCGAAAGTTT -> CCGAAAGTTTC
CCGAAAGTTTC -> CGAAAGTTTCG
CGAAAGTTTCG -> GAAAGTTTCGC
GAAAGTTTCGC -> AAAGTTTCGCA
AAAGTTTCGCA -> AAGTTTCGCAA
AAGTTTCGCAA -> AGTTTCGCAAG
AGTTTCGCAAG -> GTTTCGCAAGT
GTTTCGCAAGT -> TTTCGCAAGTA
TTTCGCAAGTA -> TTCGCAAGTAG
TTCGCAAGTAG -> TCGCAAGTAGA
TCGCAAGTAGA -> CGCAAGTAGAT
CGCAAGTAGAT -> GCAAGTAGATT
GCAAGTAGATT -> CAAGTAGATTC
CAAGTAGATTC -> AAGTAGATTCA
AAGTAGATTCA -> AGTAGATTCAC
AGTAGATTCAC -> GTAGATTCACG
GTAGATTCACG -> TAGATTCACGG
TAGATTCACGG -> AGATTCACGGT
AGATTCACGGT -> GATTCACGGTT
GATTCACGGTT -> ATTCACGGTTT
ATTCACGGTTT -> TTCACGGTTTT
TTCACGGTTTT -> TCACGGTTTTT
TCACGGTTTTT -> CACGGTTTTTG
CACGGTTTTTG -> ACGGTTTTTGA
ACGGTTTTTGA -> CGGTTTTTGAT
CGGTTTTTGAT -> GGTTTTTGATT
GGTTTTTGATT -> GTTTTTGATTC
GTTTTTGATTC -> TTTTTGATTCA
TTTTTGATTCA -> TTTTGATTCAG
TTTTGATTCAG -> TTTGATTCAGC
TTTGATTCAGC -> TTGATTCAGCA
TTGATTCAGCA -> TGATTCAGCAC
TGATTCAGCAC -> GATTCAGCACA
GATTCAGCACA -> ATTCAGCACAG
ATTCAGCACAG -> TTCAGCACAGG
TTCAGCACAGG -> TCAGCACAGGG
TCAGCACAGGG -> CAGCACAGGGA
CAGCACAGGGA -> AGCACAGGGAA
AGCACAGGGAA -> GCACAGGGAAC
GCACAGGGAAC -> CACAGGGAACC
CACAGGGAACC -> ACAGGGAACCT
ACAGGGAACCT -> CAGGGAACCTT
CAGGGAACCTT -> AGGGAACCTTC
AGGGAACCTTC -> GGGAACCTTCA
GGGAACCTTCA -> GGAACCTTCAA
GGAACCTTCAA -> GAACCTTCAAG
GAACCTTCAAG -> AACCTTCAAGC
AACCTTCAAGC -> ACCTTCAAGCT
ACCTTCAAGCT -> CCTTCAAGCTG
CCTTCAAGCTG -> CTTCAAGCTGG
CTTCAAGCTGG -> TTCAAGCTGGA
TTCAAGCTGGA -> TCAAGCTGGAC
TCAAGCTGGAC -> CAAGCTGGACA
CAAGCTGGACA -> AAGCTGGACAC
AAGCTGGACAC -> AGCTGGACACA
AGCTGGACACA -> GCTGGACACAT
GCTGGACACAT -> CTGGACACATC
CTGGACACATC -> TGGACACATCG
TGGACACATCG -> GGACACATCGT
GGACACATCGT -> GACACATCGTC
GACACATCGTC -> ACACATCGTCT
ACACATCGTCT -> CACATCGTCTG
CACATCGTCTG -> ACATCGTCTGG
ACATCGTCTGG -> CATCGTCTGGA
CATCGTCTGGA -> ATCGTCTGGAG
ATCGTCTGGAG -> TCGTCTGGAGC
TCGTCTGGAGC -> CGTCTGGAGCG
CGTCTGGAGCG -> GTCTGGAGCGT
GTCTGGAGCGT -> TCTGGAGCGTA
TCTGGAGCGTA -> CTGGAGCGTAA
CTGGAGCGTAA -> TGGAGCGTAAT
TGGAGCGTAAT -> GGAGCGTAATA
GGAGCGTAATA -> GAGCGTAATAC
GAGCGTAATAC -> AGCGTAATACT
AGCGTAATACT -> GCGTAATACTG
GCGTAATACTG -> CGTAATACTGG
CGTAATACTGG -> GTAATACTGGC
GTAATACTGGC -> TAATACTGGCG
TAATACTGGCG -> AATACTGGCGT
AATACTGGCGT -> ATACTGGCGTT
ATACTGGCGTT -> TACTGGCGTTT
TACTGGCGTTT -> ACTGGCGTTTT
ACTGGCGTTTT -> CTGGCGTTTTC
CTGGCGTTTTC -> TGGCGTTTTCC
TGGCGTTTTCC -> GGCGTTTTCCG
GGCGTTTTCCG -> GCGTTTTCCGG
GCGTTTTCCGG -> CGTTTTCCGGG
CGTTTTCCGGG -> GTTTTCCGGGG
GTTTTCCGGGG -> TTTTCCGGGGG
TTTTCCGGGGG -> TTTCCGGGGGC
TTTCCGGGGGC -> TTCCGGGGGCT
TTCCGGGGGCT -> TCCGGGGGCTA
TCCGGGGGCTA -> CCGGGGGCTAC
CCGGGGGCTAC -> CGGGGGCTACG
CGGGGGCTACG -> GGGGGCTACGG
GGGGGCTACGG -> GGGGCTACGGA
GGGGCTACGGA -> GGGCTACGGAT
GGGCTACGGAT -> GGCTACGGATC
GGCTACGGATC -> GCTACGGATCT
GCTACGGATCT -> CTACGGATCTT
CTACGGATCTT -> TACGGATCTTC
TACGGATCTTC -> ACGGATCTTCT
ACGGATCTTCT -> CGGATCTTCTA
CGGATCTTCTA -> GGATCTTCTAA
GGATCTTCTAA -> GATCTTCTAAG
GATCTTCTAAG -> ATCTTCTAAGC
ATCTTCTAAGC -> TCTTCTAAGCG
TCTTCTAAGCG -> CTTCTAAGCGG
CTTCTAAGCGG -> TTCTAAGCGGA
TTCTAAGCGGA -> TCTAAGCGGAG
TCTAAGCGGAG -> CTAAGCGGAGA
CTAAGCGGAGA -> TAAGCGGAGAG
TAAGCGGAGAG -> AAGCGGAGAGA
AAGCGGAGAGA -> AGCGGAGAGAA
AGCGGAGAGAA -> GCGGAGAGAAT
GCGGAGAGAAT -> CGGAGAGAATC
CGGAGAGAATC -> GGAGAGAATCC
GGAGAGAATCC -> GAGAGAATCCT
GAGAGAATCCT -> AGAGAATCCTA
AGAGAATCCTA -> GAGAATCCTAG
GAGAATCCTAG -> AGAATCCTAGC
AGAATCCTAGC -> GAATCCTAGCA
GAATCCTAGCA -> AATCCTAGCAA
AATCCTAGCAA -> ATCCTAGCAAC
ATCCTAGCAAC -> TCCTAGCAACG
TCCTAGCAACG -> CCTAGCAACGT
CCTAGCAACGT -> CTAGCAACGTG
CTAGCAACGTG -> TAGCAACGTGT
TAGCAACGTGT -> AGCAACGTGTA
AGCAACGTGTA -> GCAACGTGTAC
GCAACGTGTAC -> CAACGTGTACT
CAACGTGTACT -> AACGTGTACTC
AACGTGTACTC -> ACGTGTACTCA
ACGTGTACTCA -> CGTGTACTCAT
CGTGTACTCAT -> GTGTACTCATA
GTGTACTCATA -> TGTACTCATAC
TGTACTCATAC -> GTACTCATACA
GTACTCATACA -> TACTCATACAC
TACTCATACAC -> ACTCATACACA
ACTCATACACA -> CTCATACACAA
CTCATACACAA -> TCATACACAAC
TCATACACAAC -> CATACACAACC
CATACACAACC -> ATACACAACCA
ATACACAACCA -> TACACAACCAC
TACACAACCAC -> ACACAACCACG
ACACAACCACG -> CACAACCACGG
CACAACCACGG -> ACAACCACGGA
ACAACCACGGA -> CAACCACGGAG
CAACCACGGAG -> AACCACGGAGC
AACCACGGAGC -> ACCACGGAGCT
ACCACGGAGCT -> CCACGGAGCTC
CCACGGAGCTC -> CACGGAGCTCC
CACGGAGCTCC -> ACGGAGCTCCG
ACGGAGCTCCG -> CGGAGCTCCGT
CGGAGCTCCGT -> GGAGCTCCGTC
GGAGCTCCGTC -> GAGCTCCGTCT
GAGCTCCGTCT -> AGCTCCGTCTA
AGCTCCGTCTA -> GCTCCGTCTAG
GCTCCGTCTAG -> CTCCGTCTAGT
CTCCGTCTAGT -> TCCGTCTAGTT
TCCGTCTAGTT -> CCGTCTAGTTC
CCGTCTAGTTC -> CGTCTAGTTCA
CGTCTAGTTCA -> GTCTAGTTCAT
GTCTAGTTCAT -> TCTAGTTCATT
TCTAGTTCATT -> CTAGTTCATTC
CTAGTTCATTC -> TAGTTCATTCC
TAGTTCATTCC -> AGTTCATTCCG
AGTTCATTCCG -> GTTCATTCCGA
GTTCATTCCGA -> TTCATTCCGAC
TTCATTCCGAC -> TCATTCCGACT
TCATTCCGACT -> CATTCCGACTA
CATTCCGACTA -> ATTCCGACTAA
ATTCCGACTAA -> TTCCGACTAAC
TTCCGACTAAC -> TCCGACTAACC
TCCGACTAACC -> CCGACTAACCT
CCGACTAACCT -> CGACTAACCTG
CGACTAACCTG -> GACTAACCTGT
GACTAACCTGT -> ACTAACCTGTG
ACTAACCTGTG -> CTAACCTGTGG
CTAACCTGTGG -> TAACCTGTGGA
TAACCTGTGGA -> AACCTGTGGAT
AACCTGTGGAT -> ACCTGTGGATG
ACCTGTGGATG -> CCTGTGGATGA
CCTGTGGATGA -> CTGTGGATGAA
CTGTGGATGAA -> TGTGGATGAAG
TGTGGATGAAG -> GTGGATGAAGA
GTGGATGAAGA -> TGGATGAAGAT
TGGATGAAGAT -> GGATGAAGATA
GGATGAAGATA -> GATGAAGATAA
GATGAAGATAA -> ATGAAGATAAT
ATGAAGATAAT -> TGAAGATAATC
TGAAGATAATC -> GAAGATAATCT
GAAGATAATCT -> AAGATAATCTA
AAGATAATCTA -> AGATAATCTAG
AGATAATCTAG -> GATAATCTAGT
GATAATCTAGT -> ATAATCTAGTA
ATAATCTAGTA -> TAATCTAGTAT
TAATCTAGTAT -> AATCTAGTATG
AATCTAGTATG -> ATCTAGTATGT
ATCTAGTATGT -> TCTAGTATGTG
TCTAGTATGTG -> CTAGTATGTGC
CTAGTATGTGC -> TAGTATGTGCG
TAGTATGTGCG -> AGTATGTGCGT
AGTATGTGCGT -> GTATGTGCGTT
GTATGTGCGTT -> TATGTGCGTTA
TATGTGCGTTA -> ATGTGCGTTAG
ATGTGCGTTAG -> TGTGCGTTAGG
TGTGCGTTAGG -> GTGCGTTAGGC
GTGCGTTAGGC -> TGCGTTAGGCT
TGCGTTAGGCT -> GCGTTAGGCTC
GCGTTAGGCTC -> CGTTAGGCTCA
CGTTAGGCTCA -> GTTAGGCTCAT
GTTAGGCTCAT -> TTAGGCTCATT
TTAGGCTCATT -> TAGGCTCATTG
TAGGCTCATTG -> AGGCTCATTGT
AGGCTCATTGT -> GGCTCATTGTT
GGCTCATTGTT -> GCTCATTGTTG
GCTCATTGTTG -> CTCATTGTTGA
CTCATTGTTGA -> TCATTGTTGAA
TCATTGTTGAA -> CATTGTTGAAA
CATTGTTGAAA -> ATTGTTGAAAA
ATTGTTGAAAA -> TTGTTGAAAAA
TTGTTGAAAAA -> TGTTGAAAAAT
TGTTGAAAAAT -> GTTGAAAAATT
GTTGAAAAATT -> TTGAAAAATTA
TTGAAAAATTA -> TGAAAAATTAG
TGAAAAATTAG -> GAAAAATTAGT
GAAAAATTAGT -> AAAAATTAGTA
AAAAATTAGTA -> AAAATTAGTAC
AAAATTAGTAC -> AAATTAGTACG
AAATTAGTACG -> AATTAGTACGC
AATTAGTACGC -> ATTAGTACGCT
ATTAGTACGCT -> TTAGTACGCTT
TTAGTACGCTT -> TAGTACGCTTG
TAGTACGCTTG -> AGTACGCTTGG
AGTACGCTTGG -> GTACGCTTGGT
GTACGCTTGGT -> TACGCTTGGTC
TACGCTTGGTC -> ACGCTTGGTCA
ACGCTTGGTCA -> CGCTTGGTCAT
CGCTTGGTCAT -> GCTTGGTCATT
GCTTGGTCATT -> CTTGGTCATTG
CTTGGTCATTG -> TTGGTCATTGT
TTGGTCATTGT -> TGGTCATTGTT
TGGTCATTGTT -> GGTCATTGTTT
GGTCATTGTTT -> GTCATTGTTTA
GTCATTGTTTA -> TCATTGTTTAT
TCATTGTTTAT -> CATTGTTTATG
CATTGTTTATG -> ATTGTTTATGG
ATTGTTTATGG -> TTGTTTATGGT
TTGTTTATGGT -> TGTTTATGGTA
TGTTTATGGTA -> GTTTATGGTAT
GTTTATGGTAT -> TTTATGGTATC
TTTATGGTATC -> TTATGGTATCT
TTATGGTATCT -> TATGGTATCTG
TATGGTATCTG -> ATGGTATCTGG
ATGGTATCTGG -> TGGTATCTGGG
TGGTATCTGGG -> GGTATCTGGGG
GGTATCTGGGG -> GTATCTGGGGT
GTATCTGGGGT -> TATCTGGGGTT
TATCTGGGGTT -> ATCTGGGGTTT
ATCTGGGGTTT -> TCTGGGGTTTA
TCTGGGGTTTA -> CTGGGGTTTAC
CTGGGGTTTAC -> TGGGGTTTACG
TGGGGTTTACG -> GGGGTTTACGT
GGGGTTTACGT -> GGGTTTACGTT
GGGTTTACGTT -> GGTTTACGTTT
GGTTTACGTTT -> GTTTACGTTTC
GTTTACGTTTC -> TTTACGTTTCT
TTTACGTTTCT -> TTACGTTTCTC
TTACGTTTCTC -> TACGTTTCTCT
TACGTTTCTCT -> ACGTTTCTCTC
ACGTTTCTCTC -> CGTTTCTCTCG
CGTTTCTCTCG -> GTTTCTCTCGC
GTTTCTCTCGC -> TTTCTCTCGCC
TTTCTCTCGCC -> TTCTCTCGCCT
TTCTCTCGCCT -> TCTCTCGCCTA
TCTCTCGCCTA -> CTCTCGCCTAC
CTCTCGCCTAC -> TCTCGCCTACT
TCTCGCCTACT -> CTCGCCTACTC
CTCGCCTACTC -> TCGCCTACTCT
TCGCCTACTCT -> CGCCTACTCTA
CGCCTACTCTA -> GCCTACTCTAT
GCCTACTCTAT -> CCTACTCTATT
CCTACTCTATT -> CTACTCTATTT
CTACTCTATTT -> TACTCTATTTA
TACTCTATTTA -> ACTCTATTTAT
ACTCTATTTAT -> CTCTATTTATC
CTCTATTTATC -> TCTATTTATCA
TCTATTTATCA -> CTATTTATCAC
CTATTTATCAC -> TATTTATCACT
TATTTATCACT -> ATTTATCACTT
ATTTATCACTT -> TTTATCACTTC
TTTATCACTTC -> TTATCACTTCG
TTATCACTTCG -> TATCACTTCGC
TATCACTTCGC -> ATCACTTCGCA
ATCACTTCGCA -> TCACTTCGCAG
TCACTTCGCAG -> CACTTCGCAGT
CACTTCGCAGT -> ACTTCGCAGTA
ACTTCGCAGTA -> CTTCGCAGTAG
CTTCGCAGTAG -> TTCGCAGTAGT
TTCGCAGTAGT -> TCGCAGTAGTC
TCGCAGTAGTC -> CGCAGTAGTCA
CGCAGTAGTCA -> GCAGTAGTCAT
GCAGTAGTCAT -> CAGTAGTCATC
CAGTAGTCATC -> AGTAGTCATCC
AGTAGTCATCC -> GTAGTCATCCG
GTAGTCATCCG -> TAGTCATCCGC
TAGTCATCCGC -> AGTCATCCGCT
AGTCATCCGCT -> GTCATCCGCTC
GTCATCCGCTC -> TCATCCGCTCC
TCATCCGCTCC -> CATCCGCTCCA
CATCCGCTCCA -> ATCCGCTCCAT
ATCCGCTCCAT -> TCCGCTCCATG
TCCGCTCCATG -> CCGCTCCATGT
CCGCTCCATGT -> CGCTCCATGTT
CGCTCCATGTT -> GCTCCATGTTT
GCTCCATGTTT -> CTCCATGTTTT
CTCCATGTTTT -> TCCATGTTTTG
TCCATGTTTTG -> CCATGTTTTGG
CCATGTTTTGG -> CATGTTTTGGC
CATGTTTTGGC -> ATGTTTTGGCG
ATGTTTTGGCG -> TGTTTTGGCGC
TGTTTTGGCGC -> GTTTTGGCGCG
GTTTTGGCGCG -> TTTTGGCGCGT
TTTTGGCGCGT -> TTTGGCGCGTC
TTTGGCGCGTC -> TTGGCGCGTCC
TTGGCGCGTCC -> TGGCGCGTCCA
TGGCGCGTCCA -> GGCGCGTCCAT
GGCGCGTCCAT -> GCGCGTCCATG
GCGCGTCCATG -> CGCGTCCATGA
CGCGTCCATGA -> GCGTCCATGAG
GCGTCCATGAG -> CGTCCATGAGA
CGTCCATGAGA -> GTCCATGAGAG
GTCCATGAGAG -> TCCATGAGAGT
TCCATGAGAGT -> CCATGAGAGTC
CCATGAGAGTC -> CATGAGAGTCC
CATGAGAGTCC -> ATGAGAGTCCT
ATGAGAGTCCT -> TGAGAGTCCTC
TGAGAGTCCTC -> GAGAGTCCTCG
GAGAGTCCTCG -> AGAGTCCTCGA
AGAGTCCTCGA -> GAGTCCTCGAA
GAGTCCTCGAA -> AGTCCTCGAAA
AGTCCTCGAAA -> GTCCTCGAAAG
GTCCTCGAAAG -> TCCTCGAAAGC
TCCTCGAAAGC -> CCTCGAAAGCG
CCTCGAAAGCG -> CTCGAAAGCGC
CTCGAAAGCGC -> TCGAAAGCGCA
TCGAAAGCGCA -> CGAAAGCGCAA
CGAAAGCGCAA -> GAAAGCGCAAG
GAAAGCGCAAG -> AAAGCGCAAGT
AAAGCGCAAGT -> AAGCGCAAGTC
AAGCGCAAGTC -> AGCGCAAGTCC
AGCGCAAGTCC -> GCGCAAGTCCG
GCGCAAGTCCG -> CGCAAGTCCGG
CGCAAGTCCGG -> GCAAGTCCGGA
GCAAGTCCGGA -> CAAGTCCGGAG
CAAGTCCGGAG -> AAGTCCGGAGA
AAGTCCGGAGA -> AGTCCGGAGAA
AGTCCGGAGAA -> GTCCGGAGAAC
GTCCGGAGAAC -> TCCGGAGAACC
TCCGGAGAACC -> CCGGAGAACCC
CCGGAGAACCC -> CGGAGAACCCT
CGGAGAACCCT -> GGAGAACCCTC
GGAGAACCCTC -> GAGAACCCTCC
GAGAACCCTCC -> AGAACCCTCCC
AGAACCCTCCC -> GAACCCTCCCT
GAACCCTCCCT -> AACCCTCCCTA
AACCCTCCCTA -> ACCCTCCCTAA
ACCCTCCCTAA -> CCCTCCCTAAG
CCCTCCCTAAG -> CCTCCCTAAGG
CCTCCCTAAGG -> CTCCCTAAGGA
CTCCCTAAGGA -> TCCCTAAGGAG
TCCCTAAGGAG -> CCCTAAGGAGG
CCCTAAGGAGG -> CCTAAGGAGGT
CCTAAGGAGGT -> CTAAGGAGGTG
CTAAGGAGGTG -> TAAGGAGGTGG
TAAGGAGGTGG -> AAGGAGGTGGA
AAGGAGGTGGA -> AGGAGGTGGAG
AGGAGGTGGAG -> GGAGGTGGAGG
GGAGGTGGAGG -> GAGGTGGAGGT
GAGGTGGAGGT -> AGGTGGAGGTC
AGGTGGAGGTC -> GGTGGAGGTCA
GGTGGAGGTCA -> GTGGAGGTCAC
GTGGAGGTCAC -> TGGAGGTCACC
TGGAGGTCACC -> GGAGGTCACCT
GGAGGTCACCT -> GAGGTCACCTT
GAGGTCACCTT -> AGGTCACCTTC
AGGTCACCTTC -> GGTCACCTTCT
GGTCACCTTCT -> GTCACCTTCTC
GTCACCTTCTC -> TCACCTTCTCA
TCACCTTCTCA -> CACCTTCTCAT
CACCTTCTCAT -> ACCTTCTCATG
ACCTTCTCATG -> CCTTCTCATGA
CCTTCTCATGA -> CTTCTCATGAA
CTTCTCATGAA -> TTCTCATGAAC
TTCTCATGAAC -> TCTCATGAACG
TCTCATGAACG -> CTCATGAACGT
CTCATGAACGT -> TCATGAACGTG
TCATGAACGTG -> CATGAACGTGT
CATGAACGTGT -> ATGAACGTGTA
ATGAACGTGTA -> TGAACGTGTAC
TGAACGTGTAC -> GAACGTGTACG
GAACGTGTACG -> AACGTGTACGC
AACGTGTACGC -> ACGTGTACGCA
ACGTGTACGCA -> CGTGTACGCAG
CGTGTACGCAG -> GTGTACGCAGC
GTGTACGCAGC -> TGTACGCAGCA
TGTACGCAGCA -> GTACGCAGCAT
GTACGCAGCAT -> TACGCAGCATG
TACGCAGCATG -> ACGCAGCATGT
ACGCAGCATGT -> CGCAGCATGTC
CGCAGCATGTC -> GCAGCATGTCA
GCAGCATGTCA -> CAGCATGTCAG
CAGCATGTCAG -> AGCATGTCAGG
AGCATGTCAGG -> GCATGTCAGGT
GCATGTCAGGT -> CATGTCAGGTA
CATGTCAGGTA -> ATGTCAGGTAA
ATGTCAGGTAA -> TGTCAGGTAAT
TGTCAGGTAAT -> GTCAGGTAATG
GTCAGGTAATG -> TCAGGTAATGT
TCAGGTAATGT -> CAGGTAATGTG
CAGGTAATGTG -> AGGTAATGTGA
AGGTAATGTGA -> GGTAATGTGAA
GGTAATGTGAA -> GTAATGTGAAT
GTAATGTGAAT -> TAATGTGAATC
TAATGTGAATC -> AATGTGAATCT
AATGTGAATCT -> ATGTGAATCTC
ATGTGAATCTC -> TGTGAATCTCG
TGTGAATCTCG -> GTGAATCTCGG
GTGAATCTCGG -> TGAATCTCGGT
TGAATCTCGGT -> GAATCTCGGTT
GAATCTCGGTT -> AATCTCGGTTG
AATCTCGGTTG -> ATCTCGGTTGC
ATCTCGGTTGC -> TCTCGGTTGCC
TCTCGGTTGCC -> CTCGGTTGCCA
CTCGGTTGCCA -> TCGGTTGCCAA
TCGGTTGCCAA -> CGGTTGCCAAG
CGGTTGCCAAG -> GGTTGCCAAGT
GGTTGCCAAGT -> GTTGCCAAGTT
GTTGCCAAGTT -> TTGCCAAGTTA
TTGCCAAGTTA -> TGCCAAGTTAA
TGCCAAGTTAA -> GCCAAGTTAAG
GCCAAGTTAAG -> CCAAGTTAAGC
CCAAGTTAAGC -> CAAGTTAAGCG
CAAGTTAAGCG -> AAGTTAAGCGC
AAGTTAAGCGC -> AGTTAAGCGCG
AGTTAAGCGCG -> GTTAAGCGCGC
GTTAAGCGCGC -> TTAAGCGCGCC
TTAAGCGCGCC -> TAAGCGCGCCC
TAAGCGCGCCC -> AAGCGCGCCCG
AAGCGCGCCCG -> AGCGCGCCCGA
AGCGCGCCCGA -> GCGCGCCCGAG
GCGCGCCCGAG -> CGCGCCCGAGC
CGCGCCCGAGC -> GCGCCCGAGCC
GCGCCCGAGCC -> CGCCCGAGCCA
CGCCCGAGCCA -> GCCCGAGCCAA
GCCCGAGCCAA -> CCCGAGCCAAA
CCCGAGCCAAA -> CCGAGCCAAAC
CCGAGCCAAAC -> CGAGCCAAACA
CGAGCCAAACA -> GAGCCAAACAG
GAGCCAAACAG -> AGCCAAACAGT
AGCCAAACAGT -> GCCAAACAGTC
GCCAAACAGTC -> CCAAACAGTCA
CCAAACAGTCA -> CAAACAGTCAA
CAAACAGTCAA -> AAACAGTCAAC
AAACAGTCAAC -> AACAGTCAACA
AACAGTCAACA -> ACAGTCAACAT
ACAGTCAACAT -> CAGTCAACATC
CAGTCAACATC -> AGTCAACATCC
AGTCAACATCC -> GTCAACATCCG
GTCAACATCCG -> TCAACATCCGT
TCAACATCCGT -> CAACATCCGTG
CAACATCCGTG -> AACATCCGTGA
AACATCCGTGA -> ACATCCGTGAT
ACATCCGTGAT -> CATCCGTGATA
CATCCGTGATA -> ATCCGTGATAC
ATCCGTGATAC -> TCCGTGATACC
TCCGTGATACC -> CCGTGATACCG
CCGTGATACCG -> CGTGATACCGA
CGTGATACCGA -> GTGATACCGAG
GTGATACCGAG -> TGATACCGAGC
TGATACCGAGC -> GATACCGAGCA
GATACCGAGCA -> ATACCGAGCAT
ATACCGAGCAT -> TACCGAGCATG
TACCGAGCATG -> ACCGAGCATGG
ACCGAGCATGG -> CCGAGCATGGT
CCGAGCATGGT -> CGAGCATGGTA
CGAGCATGGTA -> GAGCATGGTAA
GAGCATGGTAA -> AGCATGGTAAG
AGCATGGTAAG -> GCATGGTAAGC
GCATGGTAAGC -> CATGGTAAGCC
CATGGTAAGCC -> ATGGTAAGCCG
ATGGTAAGCCG -> TGGTAAGCCGT
TGGTAAGCCGT -> GGTAAGCCGTA
GGTAAGCCGTA -> GTAAGCCGTAG
GTAAGCCGTAG -> TAAGCCGTAGC
TAAGCCGTAGC -> AAGCCGTAGCG
AAGCCGTAGCG -> AGCCGTAGCGT
AGCCGTAGCGT -> GCCGTAGCGTA
GCCGTAGCGTA -> CCGTAGCGTAC
CCGTAGCGTAC -> CGTAGCGTACA
CGTAGCGTACA -> GTAGCGTACAG
GTAGCGTACAG -> TAGCGTACAGC
TAGCGTACAGC -> AGCGTACAGCG
AGCGTACAGCG -> GCGTACAGCGA
GCGTACAGCGA -> CGTACAGCGAC
CGTACAGCGAC -> GTACAGCGACG
GTACAGCGACG -> TACAGCGACGC
TACAGCGACGC -> ACAGCGACGCT
ACAGCGACGCT -> CAGCGACGCTT
CAGCGACGCTT -> AGCGACGCTTG
AGCGACGCTTG -> GCGACGCTTGG
GCGACGCTTGG -> CGACGCTTGGA
CGACGCTTGGA -> GACGCTTGGAA
GACGCTTGGAA -> ACGCTTGGAAG
ACGCTTGGAAG -> CGCTTGGAAGG
CGCTTGGAAGG -> GCTTGGAAGGA
GCTTGGAAGGA -> CTTGGAAGGAA
CTTGGAAGGAA -> TTGGAAGGAAA
TTGGAAGGAAA -> TGGAAGGAAAA
TGGAAGGAAAA -> GGAAGGAAAAC
GGAAGGAAAAC -> GAAGGAAAACA
GAAGGAAAACA -> AAGGAAAACAA
AAGGAAAACAA -> AGGAAAACAAG
AGGAAAACAAG -> GGAAAACAAGG
GGAAAACAAGG -> GAAAACAAGGG
GAAAACAAGGG -> AAAACAAGGGA
AAAACAAGGGA -> AAACAAGGGAA
AAACAAGGGAA -> AACAAGGGAAG
AACAAGGGAAG -> ACAAGGGAAGA
ACAAGGGAAGA -> CAAGGGAAGAA
CAAGGGAAGAA -> AAGGGAAGAAT
AAGGGAAGAAT -> AGGGAAGAATA
AGGGAAGAATA -> GGGAAGAATAG
GGGAAGAATAG -> GGAAGAATAGA
GGAAGAATAGA -> GAAGAATAGAT
GAAGAATAGAT -> AAGAATAGATC
AAGAATAGATC -> AGAATAGATCC
AGAATAGATCC -> GAATAGATCCC
GAATAGATCCC -> AATAGATCCCT
AATAGATCCCT -> ATAGATCCCTG
ATAGATCCCTG -> TAGATCCCTGG
TAGATCCCTGG -> AGATCCCTGGA
AGATCCCTGGA -> GATCCCTGGAT
GATCCCTGGAT -> ATCCCTGGATC
ATCCCTGGATC -> TCCCTGGATCA
TCCCTGGATCA -> CCCTGGATCAA
CCCTGGATCAA -> CCTGGATCAAG
CCTGGATCAAG -> CTGGATCAAGC
CTGGATCAAGC -> TGGATCAAGCT
TGGATCAAGCT -> GGATCAAGCTA
GGATCAAGCTA -> GATCAAGCTAG
GATCAAGCTAG -> ATCAAGCTAGT
ATCAAGCTAGT -> TCAAGCTAGTT
TCAAGCTAGTT -> CAAGCTAGTTT
CAAGCTAGTTT -> AAGCTAGTTTT
AAGCTAGTTTT -> AGCTAGTTTTC
AGCTAGTTTTC -> GCTAGTTTTCT
GCTAGTTTTCT -> CTAGTTTTCTT
CTAGTTTTCTT -> TAGTTTTCTTG
TAGTTTTCTTG -> AGTTTTCTTGA
AGTTTTCTTGA -> GTTTTCTTGAT
GTTTTCTTGAT -> TTTTCTTGATA
TTTTCTTGATA -> TTTCTTGATAG
TTTCTTGATAG -> TTCTTGATAGG
TTCTTGATAGG -> TCTTGATAGGC
TCTTGATAGGC -> CTTGATAGGCT
CTTGATAGGCT -> TTGATAGGCTC
TTGATAGGCTC -> TGATAGGCTCA
TGATAGGCTCA -> GATAGGCTCAG
GATAGGCTCAG -> ATAGGCTCAGT
ATAGGCTCAGT -> TAGGCTCAGTA
TAGGCTCAGTA -> AGGCTCAGTAT
AGGCTCAGTAT -> GGCTCAGTATT
GGCTCAGTATT -> GCTCAGTATTA
GCTCAGTATTA -> CTCAGTATTAG
CTCAGTATTAG -> TCAGTATTAGG
TCAGTATTAGG -> CAGTATTAGGT
CAGTATTAGGT -> AGTATTAGGTT
AGTATTAGGTT -> GTATTAGGTTC
GTATTAGGTTC -> TATTAGGTTCT
TATTAGGTTCT -> ATTAGGTTCTA
ATTAGGTTCTA -> TTAGGTTCTAA
TTAGGTTCTAA -> TAGGTTCTAAT
TAGGTTCTAAT -> AGGTTCTAATC
AGGTTCTAATC -> GGTTCTAATCT
GGTTCTAATCT -> GTTCTAATCTT
GTTCTAATCTT -> TTCTAATCTTG
TTCTAATCTTG -> TCTAATCTTGT
TCTAATCTTGT -> CTAATCTTGTA
CTAATCTTGTA -> TAATCTTGTAA
TAATCTTGTAA -> AATCTTGTAAG
AATCTTGTAAG -> ATCTTGTAAGG
ATCTTGTAAGG -> TCTTGTAAGGA
TCTTGTAAGGA -> CTTGTAAGGAG
CTTGTAAGGAG -> TTGTAAGGAGG
TTGTAAGGAGG -> TGTAAGGAGGT
TGTAAGGAGGT -> GTAAGGAGGTG
GTAAGGAGGTG -> TAAGGAGGTGC
TAAGGAGGTGC -> AAGGAGGTGCC
AAGGAGGTGCC -> AGGAGGTGCCG
AGGAGGTGCCG -> GGAGGTGCCGC
GGAGGTGCCGC -> GAGGTGCCGCG
GAGGTGCCGCG -> AGGTGCCGCGG
AGGTGCCGCGG -> GGTGCCGCGGT
GGTGCCGCGGT -> GTGCCGCGGTT
GTGCCGCGGTT -> TGCCGCGGTTA
TGCCGCGGTTA -> GCCGCGGTTAG
GCCGCGGTTAG -> CCGCGGTTAGG
CCGCGGTTAGG -> CGCGGTTAGGT
CGCGGTTAGGT -> GCGGTTAGGTC
GCGGTTAGGTC -> CGGTTAGGTCT
CGGTTAGGTCT -> GGTTAGGTCTA
GGTTAGGTCTA -> GTTAGGTCTAA
GTTAGGTCTAA -> TTAGGTCTAAA
TTAGGTCTAAA -> TAGGTCTAAAC
TAGGTCTAAAC -> AGGTCTAAACC
AGGTCTAAACC -> GGTCTAAACCG
GGTCTAAACCG -> GTCTAAACCGT
GTCTAAACCGT -> TCTAAACCGTG
TCTAAACCGTG -> CTAAACCGTGC
CTAAACCGTGC -> TAAACCGTGCT
TAAACCGTGCT -> AAACCGTGCTA
AAACCGTGCTA -> AACCGTGCTAT
AACCGTGCTAT -> ACCGTGCTATC
ACCGTGCTATC -> CCGTGCTATCA
CCGTGCTATCA -> CGTGCTATCAG
CGTGCTATCAG -> GTGCTATCAGT
GTGCTATCAGT -> TGCTATCAGTA
TGCTATCAGTA -> GCTATCAGTAC
GCTATCAGTAC -> CTATCAGTACC
CTATCAGTACC -> TATCAGTACCC
TATCAGTACCC -> ATCAGTACCCT
ATCAGTACCCT -> TCAGTACCCTG
TCAGTACCCTG -> CAGTACCCTGC
CAGTACCCTGC -> AGTACCCTGCA
AGTACCCTGCA -> GTACCCTGCAG
GTACCCTGCAG -> TACCCTGCAGC
TACCCTGCAGC -> ACCCTGCAGCG
ACCCTGCAGCG -> CCCTGCAGCGC
CCCTGCAGCGC -> CCTGCAGCGCG
CCTGCAGCGCG -> CTGCAGCGCGC
CTGCAGCGCGC -> TGCAGCGCGCT
TGCAGCGCGCT -> GCAGCGCGCTG
GCAGCGCGCTG -> CAGCGCGCTGT
CAGCGCGCTGT -> AGCGCGCTGTT
AGCGCGCTGTT -> GCGCGCTGTTA
GCGCGCTGTTA -> CGCGCTGTTAA
CGCGCTGTTAA -> GCGCTGTTAAA
GCGCTGTTAAA -> CGCTGTTAAAG
CGCTGTTAAAG -> GCTGTTAAAGC
GCTGTTAAAGC -> CTGTTAAAGCC
CTGTTAAAGCC -> TGTTAAAGCCA
TGTTAAAGCCA -> GTTAAAGCCAC
GTTAAAGCCAC -> TTAAAGCCACG
TTAAAGCCACG -> TAAAGCCACGG
TAAAGCCACGG -> AAAGCCACGGT
AAAGCCACGGT -> AAGCCACGGTT
AAGCCACGGTT -> AGCCACGGTTC
AGCCACGGTTC -> GCCACGGTTCT
GCCACGGTTCT -> CCACGGTTCTC
CCACGGTTCTC -> CACGGTTCTCG
CACGGTTCTCG -> ACGGTTCTCGA
ACGGTTCTCGA -> CGGTTCTCGAC
CGGTTCTCGAC -> GGTTCTCGACT
GGTTCTCGACT -> GTTCTCGACTT
GTTCTCGACTT -> TTCTCGACTTA
TTCTCGACTTA -> TCTCGACTTAG
TCTCGACTTAG -> CTCGACTTAGG
CTCGACTTAGG -> TCGACTTAGGA
TCGACTTAGGA -> CGACTTAGGAC
CGACTTAGGAC -> GACTTAGGACT
GACTTAGGACT -> ACTTAGGACTT
ACTTAGGACTT -> CTTAGGACTTT
CTTAGGACTTT -> TTAGGACTTTT
TTAGGACTTTT -> TAGGACTTTTG
TAGGACTTTTG -> AGGACTTTTGA
AGGACTTTTGA -> GGACTTTTGAA
GGACTTTTGAA -> GACTTTTGAAG
GACTTTTGAAG -> ACTTTTGAAGG
ACTTTTGAAGG -> CTTTTGAAGGA
CTTTTGAAGGA -> TTTTGAAGGAT
TTTTGAAGGAT -> TTTGAAGGATG
TTTGAAGGATG -> TTGAAGGATGG
TTGAAGGATGG -> TGAAGGATGGA
TGAAGGATGGA -> GAAGGATGGAG
GAAGGATGGAG -> AAGGATGGAGC
AAGGATGGAGC -> AGGATGGAGCT
AGGATGGAGCT -> GGATGGAGCTT
GGATGGAGCTT -> GATGGAGCTTA
GATGGAGCTTA -> ATGGAGCTTAT
ATGGAGCTTAT -> TGGAGCTTATA
TGGAGCTTATA -> GGAGCTTATAT
GGAGCTTATAT -> GAGCTTATATT
GAGCTTATATT -> AGCTTATATTA
AGCTTATATTA -> GCTTATATTAG
GCTTATATTAG -> CTTATATTAGG
CTTATATTAGG -> TTATATTAGGA
TTATATTAGGA -> TATATTAGGAG
TATATTAGGAG -> ATATTAGGAGG
ATATTAGGAGG -> TATTAGGAGGA
TATTAGGAGGA -> ATTAGGAGGAG
ATTAGGAGGAG -> TTAGGAGGAGT
TTAGGAGGAGT -> TAGGAGGAGTT
TAGGAGGAGTT -> AGGAGGAGTTG
AGGAGGAGTTG -> GGAGGAGTTGA
GGAGGAGTTGA -> GAGGAGTTGAT
GAGGAGTTGAT -> AGGAGTTGATA
AGGAGTTGATA -> GGAGTTGATAC
GGAGTTGATAC -> GAGTTGATACG
GAGTTGATACG -> AGTTGATACGT
AGTTGATACGT -> GTTGATACGTG
GTTGATACGTG -> TTGATACGTGT
TTGATACGTGT -> TGATACGTGTC
TGATACGTGTC -> GATACGTGTCA
GATACGTGTCA -> ATACGTGTCAT
ATACGTGTCAT -> TACGTGTCATA
TACGTGTCATA -> ACGTGTCATAG
ACGTGTCATAG -> CGTGTCATAGG
CGTGTCATAGG -> GTGTCATAGGG
GTGTCATAGGG -> TGTCATAGGGC
TGTCATAGGGC -> GTCATAGGGCC
GTCATAGGGCC -> TCATAGGGCCC
TCATAGGGCCC -> CATAGGGCCCC
CATAGGGCCCC -> ATAGGGCCCCT
ATAGGGCCCCT -> TAGGGCCCCTA
TAGGGCCCCTA -> AGGGCCCCTAA
AGGGCCCCTAA -> GGGCCCCTAAC
GGGCCCCTAAC -> GGCCCCTAACA
GGCCCCTAACA -> GCCCCTAACAC
GCCCCTAACAC -> CCCCTAACACC
CCCCTAACACC -> CCCTAACACCG
CCCTAACACCG -> CCTAACACCGA
CCTAACACCGA -> CTAACACCGAA
CTAACACCGAA -> TAACACCGAAT
TAACACCGAAT -> AACACCGAATA
AACACCGAATA -> ACACCGAATAA
ACACCGAATAA -> CACCGAATAAG
CACCGAATAAG -> ACCGAATAAGT
ACCGAATAAGT -> CCGAATAAGTC
CCGAATAAGTC -> CGAATAAGTCT
CGAATAAGTCT -> GAATAAGTCTA
GAATAAGTCTA -> AATAAGTCTAC
AATAAGTCTAC -> ATAAGTCTACA
ATAAGTCTACA -> TAAGTCTACAT
TAAGTCTACAT -> AAGTCTACATT
AAGTCTACATT -> AGTCTACATTT
AGTCTACATTT -> GTCTACATTTA
GTCTACATTTA -> TCTACATTTAG
TCTACATTTAG -> CTACATTTAGT
CTACATTTAGT -> TACATTTAGTC
TACATTTAGTC -> ACATTTAGTCG
ACATTTAGTCG -> CATTTAGTCGG
CATTTAGTCGG -> ATTTAGTCGGT
ATTTAGTCGGT -> TTTAGTCGGTA
TTTAGTCGGTA -> TTAGTCGGTAC
TTAGTCGGTAC -> TAGTCGGTACA
TAGTCGGTACA -> AGTCGGTACAG
AGTCGGTACAG -> GTCGGTACAGG
GTCGGTACAGG -> TCGGTACAGGT
TCGGTACAGGT -> CGGTACAGGTG
CGGTACAGGTG -> GGTACAGGTGC
GGTACAGGTGC -> GTACAGGTGCC
GTACAGGTGCC -> TACAGGTGCCA
TACAGGTGCCA -> ACAGGTGCCAT
ACAGGTGCCAT -> CAGGTGCCATT
CAGGTGCCATT -> AGGTGCCATTG
AGGTGCCATTG -> GGTGCCATTGG
GGTGCCATTGG -> GTGCCATTGGT
GTGCCATTGGT -> TGCCATTGGTA
TGCCATTGGTA -> GCCATTGGTAG
GCCATTGGTAG -> CCATTGGTAGC
CCATTGGTAGC -> CATTGGTAGCC
CATTGGTAGCC -> ATTGGTAGCCG
ATTGGTAGCCG -> TTGGTAGCCGG
TTGGTAGCCGG -> TGGTAGCCGGG
TGGTAGCCGGG -> GGTAGCCGGGG
GGTAGCCGGGG -> GTAGCCGGGGG
GTAGCCGGGGG -> TAGCCGGGGGA
TAGCCGGGGGA -> AGCCGGGGGAC
AGCCGGGGGAC -> GCCGGGGGACT
GCCGGGGGACT -> CCGGGGGACTC
CCGGGGGACTC -> CGGGGGACTCT
CGGGGGACTCT -> GGGGGACTCTC
GGGGGACTCTC -> GGGGACTCTCT
GGGGACTCTCT -> GGGACTCTCTA
GGGACTCTCTA -> GGACTCTCTAA
GGACTCTCTAA -> GACTCTCTAAA
GACTCTCTAAA -> ACTCTCTAAAT
ACTCTCTAAAT -> CTCTCTAAATT
CTCTCTAAATT -> TCTCTAAATTC
TCTCTAAATTC -> CTCTAAATTCA
CTCTAAATTCA -> TCTAAATTCAC
TCTAAATTCAC -> CTAAATTCACA
CTAAATTCACA -> TAAATTCACAG
TAAATTCACAG -> AAATTCACAGG
AAATTCACAGG -> AATTCACAGGT
AATTCACAGGT -> ATTCACAGGTG
ATTCACAGGTG -> TTCACAGGTGG
TTCACAGGTGG -> TCACAGGTGGC
TCACAGGTGGC -> CACAGGTGGCA
CACAGGTGGCA -> ACAGGTGGCAA
ACAGGTGGCAA -> CAGGTGGCAAG
CAGGTGGCAAG -> AGGTGGCAAGA
AGGTGGCAAGA -> GGTGGCAAGAC
GGTGGCAAGAC -> GTGGCAAGACA
GTGGCAAGACA -> TGGCAAGACAA
TGGCAAGACAA -> GGCAAGACAAG
GGCAAGACAAG -> GCAAGACAAGC
GCAAGACAAGC -> CAAGACAAGCG
CAAGACAAGCG -> AAGACAAGCGC
AAGACAAGCGC -> AGACAAGCGCG
AGACAAGCGCG -> GACAAGCGCGT
GACAAGCGCGT -> ACAAGCGCGTT
ACAAGCGCGTT -> CAAGCGCGTTT
CAAGCGCGTTT -> AAGCGCGTTTA
AAGCGCGTTTA -> AGCGCGTTTAC
AGCGCGTTTAC -> GCGCGTTTACC
GCGCGTTTACC -> CGCGTTTACCC
CGCGTTTACCC -> GCGTTTACCCG
GCGTTTACCCG -> CGTTTACCCGA
CGTTTACCCGA -> GTTTACCCGAA
GTTTACCCGAA -> TTTACCCGAAC
TTTACCCGAAC -> TTACCCGAACC
TTACCCGAACC -> TACCCGAACCC
TACCCGAACCC -> ACCCGAACCCG
ACCCGAACCCG -> CCCGAACCCGC
CCCGAACCCGC -> CCGAACCCGCC
CCGAACCCGCC -> CGAACCCGCCT
CGAACCCGCCT -> GAACCCGCCTG
GAACCCGCCTG -> AACCCGCCTGC
AACCCGCCTGC -> ACCCGCCTGCA
ACCCGCCTGCA -> CCCGCCTGCAT
CCCGCCTGCAT -> CCGCCTGCATT
CCGCCTGCATT -> CGCCTGCATTA
CGCCTGCATTA -> GCCTGCATTAC
GCCTGCATTAC -> CCTGCATTACG
CCTGCATTACG -> CTGCATTACGA
CTGCATTACGA -> TGCATTACGAC
TGCATTACGAC -> GCATTACGACC
GCATTACGACC -> CATTACGACCA
CATTACGACCA -> ATTACGACCAC
ATTACGACCAC -> TTACGACCACG
TTACGACCACG -> TACGACCACGA
TACGACCACGA -> ACGACCACGAC
ACGACCACGAC -> CGACCACGACG
CGACCACGACG -> GACCACGACGG
GACCACGACGG -> ACCACGACGGT
ACCACGACGGT -> CCACGACGGTC
CCACGACGGTC -> CACGACGGTCC
CACGACGGTCC -> ACGACGGTCCG
ACGACGGTCCG -> CGACGGTCCGG
CGACGGTCCGG -> GACGGTCCGGG
GACGGTCCGGG -> ACGGTCCGGGC
ACGGTCCGGGC -> CGGTCCGGGCT
CGGTCCGGGCT -> GGTCCGGGCTT
GGTCCGGGCTT -> GTCCGGGCTTC
GTCCGGGCTTC -> TCCGGGCTTCT
TCCGGGCTTCT -> CCGGGCTTCTA
CCGGGCTTCTA -> CGGGCTTCTAG
CGGGCTTCTAG -> GGGCTTCTAGC
GGGCTTCTAGC -> GGCTTCTAGCA
GGCTTCTAGCA -> GCTTCTAGCAC
GCTTCTAGCAC -> CTTCTAGCACC
CTTCTAGCACC -> TTCTAGCACCT
TTCTAGCACCT -> TCTAGCACCTT
TCTAGCACCTT -> CTAGCACCTTT
CTAGCACCTTT -> TAGCACCTTTC
TAGCACCTTTC -> AGCACCTTTCG
AGCACCTTTCG -> GCACCTTTCGG
GCACCTTTCGG -> CACCTTTCGGA
CACCTTTCGGA -> ACCTTTCGGAG
ACCTTTCGGAG -> CCTTTCGGAGA
CCTTTCGGAGA -> CTTTCGGAGAG
CTTTCGGAGAG -> TTTCGGAGAGC
TTTCGGAGAGC -> TTCGGAGAGCT
TTCGGAGAGCT -> TCGGAGAGCTA
TCGGAGAGCTA -> CGGAGAGCTAA
CGGAGAGCTAA -> GGAGAGCTAAT
GGAGAGCTAAT -> GAGAGCTAATC
GAGAGCTAATC -> AGAGCTAATCC
AGAGCTAATCC -> GAGCTAATCCT
GAGCTAATCCT -> AGCTAATCCTC
AGCTAATCCTC -> GCTAATCCTCC
GCTAATCCTCC -> CTAATCCTCCA
CTAATCCTCCA -> TAATCCTCCAG
TAATCCTCCAG -> AATCCTCCAGT
AATCCTCCAGT -> ATCCTCCAGTC
ATCCTCCAGTC -> TCCTCCAGTCA
TCCTCCAGTCA -> CCTCCAGTCAC
CCTCCAGTCAC -> CTCCAGTCACC
CTCCAGTCACC -> TCCAGTCACCT
TCCAGTCACCT -> CCAGTCACCTG
CCAGTCACCTG -> CAGTCACCTGC
CAGTCACCTGC -> AGTCACCTGCT
AGTCACCTGCT -> GTCACCTGCTA
GTCACCTGCTA -> TCACCTGCTAG
TCACCTGCTAG -> CACCTGCTAGA
CACCTGCTAGA -> ACCTGCTAGAC
ACCTGCTAGAC -> CCTGCTAGACG
CCTGCTAGACG -> CTGCTAGACGT
CTGCTAGACGT -> TGCTAGACGTG
TGCTAGACGTG -> GCTAGACGTGT
GCTAGACGTGT -> CTAGACGTGTG
CTAGACGTGTG -> TAGACGTGTGC
TAGACGTGTGC -> AGACGTGTGCT
AGACGTGTGCT -> GACGTGTGCTA
GACGTGTGCTA -> ACGTGTGCTAC
ACGTGTGCTAC -> CGTGTGCTACG
CGTGTGCTACG -> GTGTGCTACGG
GTGTGCTACGG -> TGTGCTACGGG
TGTGCTACGGG -> GTGCTACGGGC
GTGCTACGGGC -> TGCTACGGGCG
TGCTACGGGCG -> GCTACGGGCGC
GCTACGGGCGC -> CTACGGGCGCC
CTACGGGCGCC -> TACGGGCGCCT
TACGGGCGCCT -> ACGGGCGCCTG
ACGGGCGCCTG -> CGGGCGCCTGG
CGGGCGCCTGG -> GGGCGCCTGGC
GGGCGCCTGGC -> GGCGCCTGGCC
GGCGCCTGGCC -> GCGCCTGGCCG
GCGCCTGGCCG -> CGCCTGGCCGT
CGCCTGGCCGT -> GCCTGGCCGTC
GCCTGGCCGTC -> CCTGGCCGTCA
CCTGGCCGTCA -> CTGGCCGTCAA
CTGGCCGTCAA -> TGGCCGTCAAT
TGGCCGTCAAT -> GGCCGTCAATA
GGCCGTCAATA -> GCCGTCAATAA
GCCGTCAATAA -> CCGTCAATAAC
CCGTCAATAAC -> CGTCAATAACG
CGTCAATAACG -> GTCAATAACGC
GTCAATAACGC -> TCAATAACGCA
TCAATAACGCA -> CAATAACGCAG
CAATAACGCAG -> AATAACGCAGG
AATAACGCAGG -> ATAACGCAGGA
ATAACGCAGGA -> TAACGCAGGAC
TAACGCAGGAC -> AACGCAGGACC
AACGCAGGACC -> ACGCAGGACCG
ACGCAGGACCG -> CGCAGGACCGT
CGCAGGACCGT -> GCAGGACCGTC
GCAGGACCGTC -> CAGGACCGTCG
CAGGACCGTCG -> AGGACCGTCGG
AGGACCGTCGG -> GGACCGTCGGC
GGACCGTCGGC -> GACCGTCGGCG
GACCGTCGGCG -> ACCGTCGGCGC
ACCGTCGGCGC -> CCGTCGGCGCG
CCGTCGGCGCG -> CGTCGGCGCGT
CGTCGGCGCGT -> GTCGGCGCGTC
GTCGGCGCGTC -> TCGGCGCGTCA
TCGGCGCGTCA -> CGGCGCGTCAG
CGGCGCGTCAG -> GGCGCGTCAGC
GGCGCGTCAGC -> GCGCGTCAGCT
GCGCGTCAGCT -> CGCGTCAGCTA
CGCGTCAGCTA -> GCGTCAGCTAC
GCGTCAGCTAC -> CGTCAGCTACT
CGTCAGCTACT -> GTCAGCTACTC
GTCAGCTACTC -> TCAGCTACTCT
TCAGCTACTCT -> CAGCTACTCTG
CAGCTACTCTG -> AGCTACTCTGC
AGCTACTCTGC -> GCTACTCTGCT
GCTACTCTGCT -> CTACTCTGCTT
CTACTCTGCTT -> TACTCTGCTTC
TACTCTGCTTC -> ACTCTGCTTCT
ACTCTGCTTCT -> CTCTGCTTCTG
CTCTGCTTCTG -> TCTGCTTCTGA
TCTGCTTCTGA -> CTGCTTCTGAT
CTGCTTCTGAT -> TGCTTCTGATA
TGCTTCTGATA -> GCTTCTGATAT
GCTTCTGATAT -> CTTCTGATATC
CTTCTGATATC -> TTCTGATATCA
TTCTGATATCA -> TCTGATATCAC
TCTGATATCAC -> CTGATATCACG
CTGATATCACG -> TGATATCACGC
TGATATCACGC -> GATATCACGCG
GATATCACGCG -> ATATCACGCGC
ATATCACGCGC -> TATCACGCGCT
TATCACGCGCT -> ATCACGCGCTA
ATCACGCGCTA -> TCACGCGCTAG
TCACGCGCTAG -> CACGCGCTAGG
CACGCGCTAGG -> ACGCGCTAGGA
ACGCGCTAGGA -> CGCGCTAGGAA
CGCGCTAGGAA -> GCGCTAGGAAA
GCGCTAGGAAA -> CGCTAGGAAAA
CGCTAGGAAAA -> GCTAGGAAAAA
GCTAGGAAAAA -> CTAGGAAAAAC
CTAGGAAAAAC -> TAGGAAAAACT
TAGGAAAAACT -> AGGAAAAACTT
AGGAAAAACTT -> GGAAAAACTTG
GGAAAAACTTG -> GAAAAACTTGA
GAAAAACTTGA -> AAAAACTTGAG
AAAAACTTGAG -> AAAACTTGAGT
AAAACTTGAGT -> AAACTTGAGTG
AAACTTGAGTG -> AACTTGAGTGT
AACTTGAGTGT -> ACTTGAGTGTG
ACTTGAGTGTG -> CTTGAGTGTGA
CTTGAGTGTGA -> TTGAGTGTGAA
TTGAGTGTGAA -> TGAGTGTGAAA
TGAGTGTGAAA -> GAGTGTGAAAG
GAGTGTGAAAG -> AGTGTGAAAGG
AGTGTGAAAGG -> GTGTGAAAGGA
GTGTGAAAGGA -> TGTGAAAGGAT
TGTGAAAGGAT -> GTGAAAGGATA
GTGAAAGGATA -> TGAAAGGATAG
TGAAAGGATAG -> GAAAGGATAGG
GAAAGGATAGG -> AAAGGATAGGA
AAAGGATAGGA -> AAGGATAGGAT
AAGGATAGGAT -> AGGATAGGATG
AGGATAGGATG -> GGATAGGATGG
GGATAGGATGG -> GATAGGATGGC
GATAGGATGGC -> ATAGGATGGCC
ATAGGATGGCC -> TAGGATGGCCG
TAGGATGGCCG -> AGGATGGCCGT
AGGATGGCCGT -> GGATGGCCGTT
GGATGGCCGTT -> GATGGCCGTTC
GATGGCCGTTC -> ATGGCCGTTCA
ATGGCCGTTCA -> TGGCCGTTCAA
TGGCCGTTCAA -> GGCCGTTCAAA
GGCCGTTCAAA -> GCCGTTCAAAT
GCCGTTCAAAT -> CCGTTCAAATA
CCGTTCAAATA -> CGTTCAAATAT
CGTTCAAATAT -> GTTCAAATATC
GTTCAAATATC -> TTCAAATATCT
TTCAAATATCT -> TCAAATATCTC
TCAAATATCTC -> CAAATATCTCC
CAAATATCTCC -> AAATATCTCCG
AAATATCTCCG -> AATATCTCCGG
AATATCTCCGG -> ATATCTCCGGT
ATATCTCCGGT -> TATCTCCGGTA
TATCTCCGGTA -> ATCTCCGGTAG
ATCTCCGGTAG -> TCTCCGGTAGT
TCTCCGGTAGT -> CTCCGGTAGTC
CTCCGGTAGTC -> TCCGGTAGTCC
TCCGGTAGTCC -> CCGGTAGTCCT
CCGGTAGTCCT -> CGGTAGTCCTC
CGGTAGTCCTC -> GGTAGTCCTCT
GGTAGTCCTCT -> GTAGTCCTCTG
GTAGTCCTCTG -> TAGTCCTCTGA
TAGTCCTCTGA -> AGTCCTCTGAT
AGTCCTCTGAT -> GTCCTCTGATG
GTCCTCTGATG -> TCCTCTGATGC
TCCTCTGATGC -> CCTCTGATGCT
CCTCTGATGCT -> CTCTGATGCTT
CTCTGATGCTT -> TCTGATGCTTC
TCTGATGCTTC -> CTGATGCTTCT
CTGATGCTTCT -> TGATGCTTCTC
TGATGCTTCTC -> GATGCTTCTCT
GATGCTTCTCT -> ATGCTTCTCTC
ATGCTTCTCTC -> TGCTTCTCTCT
TGCTTCTCTCT -> GCTTCTCTCTT
GCTTCTCTCTT -> CTTCTCTCTTA
CTTCTCTCTTA -> TTCTCTCTTAC
TTCTCTCTTAC -> TCTCTCTTACT
TCTCTCTTACT -> CTCTCTTACTC
CTCTCTTACTC -> TCTCTTACTCT
TCTCTTACTCT -> CTCTTACTCTA
CTCTTACTCTA -> TCTTACTCTAC
TCTTACTCTAC -> CTTACTCTACC
CTTACTCTACC -> TTACTCTACCC
TTACTCTACCC -> TACTCTACCCG
ACTCTACCCGT -> CTCTACCCGTC
CTCTACCCGTC -> TCTACCCGTCT
TCTACCCGTCT -> CTACCCGTCTA
CTACCCGTCTA -> TACCCGTCTAG
TACCCGTCTAG -> ACCCGTCTAGA
ACCCGTCTAGA -> CCCGTCTAGAC
CCCGTCTAGAC -> CCGTCTAGACT
CCGTCTAGACT -> CGTCTAGACTA
CGTCTAGACTA -> GTCTAGACTAA
GTCTAGACTAA -> TCTAGACTAAA
TCTAGACTAAA -> CTAGACTAAAA
CTAGACTAAAA -> TAGACTAAAAT
TAGACTAAAAT -> AGACTAAAATC
AGACTAAAATC -> GACTAAAATCG
GACTAAAATCG -> ACTAAAATCGG
ACTAAAATCGG -> CTAAAATCGGC
CTAAAATCGGC -> TAAAATCGGCT
TAAAATCGGCT -> AAAATCGGCTT
AAAATCGGCTT -> AAATCGGCTTC
AAATCGGCTTC -> AATCGGCTTCA
AATCGGCTTCA -> ATCGGCTTCAG
ATCGGCTTCAG -> TCGGCTTCAGC
TCGGCTTCAGC -> CGGCTTCAGCA
CGGCTTCAGCA -> GGCTTCAGCAG
GGCTTCAGCAG -> GCTTCAGCAGC
GCTTCAGCAGC -> CTTCAGCAGCA
CTTCAGCAGCA -> TTCAGCAGCAA
TTCAGCAGCAA -> TCAGCAGCAAC
TCAGCAGCAAC -> CAGCAGCAACT
CAGCAGCAACT -> AGCAGCAACTA
AGCAGCAACTA -> GCAGCAACTAC
GCAGCAACTAC -> CAGCAACTACC
CAGCAACTACC -> AGCAACTACCC
AGCAACTACCC -> GCAACTACCCC
GCAACTACCCC -> CAACTACCCCT
CAACTACCCCT -> AACTACCCCTT
AACTACCCCTT -> ACTACCCCTTG
ACTACCCCTTG -> CTACCCCTTGT
CTACCCCTTGT -> TACCCCTTGTC
TACCCCTTGTC -> ACCCCTTGTCG
ACCCCTTGTCG -> CCCCTTGTCGT
CCCCTTGTCGT -> CCCTTGTCGTT
CCCTTGTCGTT -> CCTTGTCGTTA
CCTTGTCGTTA -> CTTGTCGTTAT
CTTGTCGTTAT -> TTGTCGTTATC
TTGTCGTTATC -> TGTCGTTATCT
TGTCGTTATCT -> GTCGTTATCTT
GTCGTTATCTT -> TCGTTATCTTA
TCGTTATCTTA -> CGTTATCTTAG
CGTTATCTTAG -> GTTATCTTAGC
GTTATCTTAGC -> TTATCTTAGCG
TTATCTTAGCG -> TATCTTAGCGA
TATCTTAGCGA -> ATCTTAGCGAC
ATCTTAGCGAC -> TCTTAGCGACT
TCTTAGCGACT -> CTTAGCGACTA
CTTAGCGACTA -> TTAGCGACTAC
TTAGCGACTAC -> TAGCGACTACT
TAGCGACTACT -> AGCGACTACTT
AGCGACTACTT -> GCGACTACTTT
GCGACTACTTT -> CGACTACTTTC
CGACTACTTTC -> GACTACTTTCG
GACTACTTTCG -> ACTACTTTCGT
ACTACTTTCGT -> CTACTTTCGTT
CTACTTTCGTT -> TACTTTCGTTC
TACTTTCGTTC -> ACTTTCGTTCG
ACTTTCGTTCG -> CTTTCGTTCGT
CTTTCGTTCGT -> TTTCGTTCGTC
TTTCGTTCGTC -> TTCGTTCGTCT
TTCGTTCGTCT -> TCGTTCGTCTG
TCGTTCGTCTG -> CGTTCGTCTGG
CGTTCGTCTGG -> GTTCGTCTGGT
GTTCGTCTGGT -> TTCGTCTGGTA
TTCGTCTGGTA -> TCGTCTGGTAG
TCGTCTGGTAG -> CGTCTGGTAGT
CGTCTGGTAGT -> GTCTGGTAGTT
GTCTGGTAGTT -> TCTGGTAGTTC
TCTGGTAGTTC -> CTGGTAGTTCG
CTGGTAGTTCG -> TGGTAGTTCGT
TGGTAGTTCGT -> GGTAGTTCGTT
GGTAGTTCGTT -> GTAGTTCGTTC
GTAGTTCGTTC -> TAGTTCGTTCC
TAGTTCGTTCC -> AGTTCGTTCCT
AGTTCGTTCCT -> GTTCGTTCCTC
GTTCGTTCCTC -> TTCGTTCCTCG
TTCGTTCCTCG -> TCGTTCCTCGC
TCGTTCCTCGC -> CGTTCCTCGCC
CGTTCCTCGCC -> GTTCCTCGCCC
GTTCCTCGCCC -> TTCCTCGCCCT
TTCCTCGCCCT -> TCCTCGCCCTG
TCCTCGCCCTG -> CCTCGCCCTGT
CCTCGCCCTGT -> CTCGCCCTGTG
CTCGCCCTGTG -> TCGCCCTGTGT
TCGCCCTGTGT -> CGCCCTGTGTT
CGCCCTGTGTT -> GCCCTGTGTTG
GCCCTGTGTTG -> CCCTGTGTTGC
CCCTGTGTTGC -> CCTGTGTTGCT
CCTGTGTTGCT -> CTGTGTTGCTA
CTGTGTTGCTA -> TGTGTTGCTAT
TGTGTTGCTAT -> GTGTTGCTATA
GTGTTGCTATA -> TGTTGCTATAA
TGTTGCTATAA -> GTTGCTATAAT
GTTGCTATAAT -> TTGCTATAATC
TTGCTATAATC -> TGCTATAATCC
TGCTATAATCC -> GCTATAATCCG
GCTATAATCCG -> CTATAATCCGA
CTATAATCCGA -> TATAATCCGAG
TATAATCCGAG -> ATAATCCGAGT
ATAATCCGAGT -> TAATCCGAGTT
TAATCCGAGTT -> AATCCGAGTTA
AATCCGAGTTA -> ATCCGAGTTAA
ATCCGAGTTAA -> TCCGAGTTAAG
TCCGAGTTAAG -> CCGAGTTAAGT
CCGAGTTAAGT -> CGAGTTAAGTT
CGAGTTAAGTT -> GAGTTAAGTTT
GAGTTAAGTTT -> AGTTAAGTTTA
AGTTAAGTTTA -> GTTAAGTTTAT
GTTAAGTTTAT -> TTAAGTTTATG
TTAAGTTTATG -> TAAGTTTATGT
TAAGTTTATGT -> AAGTTTATGTG
AAGTTTATGTG -> AGTTTATGTGA
AGTTTATGTGA -> GTTTATGTGAT
GTTTATGTGAT -> TTTATGTGATG
TTTATGTGATG -> TTATGTGATGG
TTATGTGATGG -> TATGTGATGGT
TATGTGATGGT -> ATGTGATGGTC
ATGTGATGGTC -> TGTGATGGTCA
TGTGATGGTCA -> GTGATGGTCAC
GTGATGGTCAC -> TGATGGTCACT
TGATGGTCACT -> GATGGTCACTT
GATGGTCACTT -> ATGGTCACTTG
ATGGTCACTTG -> TGGTCACTTGG
TGGTCACTTGG -> GGTCACTTGGA
GGTCACTTGGA -> GTCACTTGGAG
GTCACTTGGAG -> TCACTTGGAGA
TCACTTGGAGA -> CACTTGGAGAC
CACTTGGAGAC -> ACTTGGAGACT
ACTTGGAGACT -> CTTGGAGACTT
CTTGGAGACTT -> TTGGAGACTTT
TTGGAGACTTT -> TGGAGACTTTC
TGGAGACTTTC -> GGAGACTTTCA
GGAGACTTTCA -> GAGACTTTCAG
GAGACTTTCAG -> AGACTTTCAGC
AGACTTTCAGC -> GACTTTCAGCA
GACTTTCAGCA -> ACTTTCAGCAC
ACTTTCAGCAC -> CTTTCAGCACG
CTTTCAGCACG -> TTTCAGCACGT
TTTCAGCACGT -> TTCAGCACGTA
TTCAGCACGTA -> TCAGCACGTAA
TCAGCACGTAA -> CAGCACGTAAT
CAGCACGTAAT -> AGCACGTAATA
AGCACGTAATA -> GCACGTAATAT
GCACGTAATAT -> CACGTAATATA
CACGTAATATA -> ACGTAATATAG
ACGTAATATAG -> CGTAATATAGG
CGTAATATAGG -> GTAATATAGGA
GTAATATAGGA -> TAATATAGGAT
TAATATAGGAT -> AATATAGGATT
AATATAGGATT -> ATATAGGATTC
ATATAGGATTC -> TATAGGATTCT
TATAGGATTCT -> ATAGGATTCTG
ATAGGATTCTG -> TAGGATTCTGG
TAGGATTCTGG -> AGGATTCTGGG
AGGATTCTGGG -> GGATTCTGGGG
GGATTCTGGGG -> GATTCTGGGGC
GATTCTGGGGC -> ATTCTGGGGCG
ATTCTGGGGCG -> TTCTGGGGCGC
TTCTGGGGCGC -> TCTGGGGCGCT
TCTGGGGCGCT -> CTGGGGCGCTG
CTGGGGCGCTG -> TGGGGCGCTGA
TGGGGCGCTGA -> GGGGCGCTGAA
GGGGCGCTGAA -> GGGCGCTGAAG
GGGCGCTGAAG -> GGCGCTGAAGG
GGCGCTGAAGG -> GCGCTGAAGGG
GCGCTGAAGGG -> CGCTGAAGGGT
CGCTGAAGGGT -> GCTGAAGGGTG
GCTGAAGGGTG -> CTGAAGGGTGG
CTGAAGGGTGG -> TGAAGGGTGGA
TGAAGGGTGGA -> GAAGGGTGGAG
GAAGGGTGGAG -> AAGGGTGGAGT
AAGGGTGGAGT -> AGGGTGGAGTT
AGGGTGGAGTT -> GGGTGGAGTTC
GGGTGGAGTTC -> GGTGGAGTTCA
GGTGGAGTTCA -> GTGGAGTTCAA
GTGGAGTTCAA -> TGGAGTTCAAT
TGGAGTTCAAT -> GGAGTTCAATT
GGAGTTCAATT -> GAGTTCAATTT
GAGTTCAATTT -> AGTTCAATTTT
AGTTCAATTTT -> GTTCAATTTTC
GTTCAATTTTC -> TTCAATTTTCG
TTCAATTTTCG -> TCAATTTTCGT
TCAATTTTCGT -> CAATTTTCGTA
CAATTTTCGTA -> AATTTTCGTAG
AATTTTCGTAG -> ATTTTCGTAGA
ATTTTCGTAGA -> TTTTCGTAGAG
TTTTCGTAGAG -> TTTCGTAGAGT
TTTCGTAGAGT -> TTCGTAGAGTA
TTCGTAGAGTA -> TCGTAGAGTAT
TCGTAGAGTAT -> CGTAGAGTATT
CGTAGAGTATT -> GTAGAGTATTA
GTAGAGTATTA -> TAGAGTATTAT
TAGAGTATTAT -> AGAGTATTATC
AGAGTATTATC -> GAGTATTATCA
GAGTATTATCA -> AGTATTATCAA
AGTATTATCAA -> GTATTATCAAC
GTATTATCAAC -> TATTATCAACT
TATTATCAACT -> ATTATCAACTG
ATTATCAACTG -> TTATCAACTGT
TTATCAACTGT -> TATCAACTGTT
TATCAACTGTT -> ATCAACTGTTA
ATCAACTGTTA -> TCAACTGTTAA
TCAACTGTTAA -> CAACTGTTAAG
CAACTGTTAAG -> AACTGTTAAGA
AACTGTTAAGA -> ACTGTTAAGAT
ACTGTTAAGAT -> CTGTTAAGATA
CTGTTAAGATA -> TGTTAAGATAG
TGTTAAGATAG -> GTTAAGATAGC
GTTAAGATAGC -> TTAAGATAGCA
TTAAGATAGCA -> TAAGATAGCAC
TAAGATAGCAC -> AAGATAGCACA
AAGATAGCACA -> AGATAGCACAC
AGATAGCACAC -> GATAGCACACC
GATAGCACACC -> ATAGCACACCC
ATAGCACACCC -> TAGCACACCCC
TAGCACACCCC -> AGCACACCCCA
AGCACACCCCA -> GCACACCCCAA
GCACACCCCAA -> CACACCCCAAA
CACACCCCAAA -> ACACCCCAAAG
ACACCCCAAAG -> CACCCCAAAGC
CACCCCAAAGC -> ACCCCAAAGCG
ACCCCAAAGCG -> CCCCAAAGCGC
CCCCAAAGCGC -> CCCAAAGCGCC
CCCAAAGCGCC -> CCAAAGCGCCA
CCAAAGCGCCA -> CAAAGCGCCAT
CAAAGCGCCAT -> AAAGCGCCATT
AAAGCGCCATT -> AAGCGCCATTA
AAGCGCCATTA -> AGCGCCATTAG
AGCGCCATTAG -> GCGCCATTAGT
GCGCCATTAGT -> CGCCATTAGTC
CGCCATTAGTC -> GCCATTAGTCC
GCCATTAGTCC -> CCATTAGTCCC
CCATTAGTCCC -> CATTAGTCCCG
CATTAGTCCCG -> ATTAGTCCCGG
ATTAGTCCCGG -> TTAGTCCCGGT
TTAGTCCCGGT -> TAGTCCCGGTC
TAGTCCCGGTC -> AGTCCCGGTCT
AGTCCCGGTCT -> GTCCCGGTCTG
GTCCCGGTCTG -> TCCCGGTCTGT
TCCCGGTCTGT -> CCCGGTCTGTA
CCCGGTCTGTA -> CCGGTCTGTAG
CCGGTCTGTAG -> CGGTCTGTAGA
CGGTCTGTAGA -> GGTCTGTAGAA
GGTCTGTAGAA -> GTCTGTAGAAC
GTCTGTAGAAC -> TCTGTAGAACA
TCTGTAGAACA -> CTGTAGAACAA
CTGTAGAACAA -> TGTAGAACAAA
TGTAGAACAAA -> GTAGAACAAAG
GTAGAACAAAG -> TAGAACAAAGA
TAGAACAAAGA -> AGAACAAAGAA
